SampleID	Tissue	Genotype	Treatment	Replicate	total	passed	failed	pair	pair_bad	pair_dup	pair_map	pair_map_hq	pair_map_hq0	pair_map0	pair_orphan	pair_orphan_hq	pair_orphan_hq0	pair_orphan0	pair_unmap	unpair	unpair_bad	unpair_dup	unpair_map	unpair_map_hq	unpair_map_hq0	unpair_map0	unpair_unmap	Assigned	Unassigned_MultiMapping	Unassigned_NoFeatures	Unassigned_Ambiguity	Unassigned_Unmapped
A01	leaf_2	B73	day9_11am_control	1	2569273	2528694	40579	0	0	0	0	0	0	0	0	0	0	0	0	2528694	0	0	2268938	1746651	1195020	1502181	259756	1324592	0	389756	32303	259756
A02	leaf_2	B73	day10_4pm_control	1	4895743	4856401	39342	0	0	0	0	0	0	0	0	0	0	0	0	4856401	0	0	4532665	4141599	2866984	3107378	323736	3035541	0	1036540	69518	323736
A03	leaf_2	B73	day9_4pm_cold	1	6042528	5970798	71730	0	0	0	0	0	0	0	0	0	0	0	0	5970798	0	0	5639052	5042950	3496580	3865440	331746	3730326	0	1224745	87879	331746
A04	leaf_2	B73	day11_11am_cold	1	6354746	6292367	62379	0	0	0	0	0	0	0	0	0	0	0	0	6292367	0	0	5892453	5251392	3650510	4043294	399914	3690209	0	1481509	79674	399914
A05	leaf_2	B73	day12_4pm_control	1	6291714	6220570	71144	0	0	0	0	0	0	0	0	0	0	0	0	6220570	0	0	5884864	5478071	3819055	4071741	335706	4059418	0	1321485	97168	335706
A06	leaf_2	B73	day15_4pm_control	1	8041159	7983162	57997	0	0	0	0	0	0	0	0	0	0	0	0	7983162	0	0	7424133	6900783	4392007	4694917	559029	5163062	0	1594569	143152	559029
A07	leaf_3	B73	day15_4pm_control	1	4693395	4624397	68998	0	0	0	0	0	0	0	0	0	0	0	0	4624397	0	0	4189288	3984336	2740184	2854088	435109	2958640	0	937586	88110	435109
A08	leaf_2	B73	day9_11am_control	2	3858046	3788587	69459	0	0	0	0	0	0	0	0	0	0	0	0	3788587	0	0	3299786	2983170	2048286	2202559	488801	2166674	0	760945	55551	488801
A09	leaf_2	B73	day11_4pm_cold	1	7884099	7803876	80223	0	0	0	0	0	0	0	0	0	0	0	0	7803876	0	0	7464977	6965959	4895410	5218411	338899	5328082	0	1482414	155463	338899
A10	leaf_2	B73	day11_11am_control	1	8531420	8454199	77221	0	0	0	0	0	0	0	0	0	0	0	0	8454199	0	0	8173067	7555320	5197715	5596594	281132	5768572	0	1651790	134958	281132
A11	leaf_2	B73	day11_4pm_control	1	4217072	4184806	32266	0	0	0	0	0	0	0	0	0	0	0	0	4184806	0	0	4027889	3870110	2688907	2794308	156917	2917918	0	890562	61630	156917
A12	leaf_2	B73	day9_4pm_cold	2	2554061	2533538	20523	0	0	0	0	0	0	0	0	0	0	0	0	2533538	0	0	2393834	1965972	1341152	1609371	139704	1480651	0	452924	32397	139704
B01	leaf_2	B73	day9_11am_control	3	6924938	6849548	75390	0	0	0	0	0	0	0	0	0	0	0	0	6849548	0	0	6375461	5828132	3995211	4320268	474087	4356536	0	1364957	106639	474087
B02	leaf_2	B73	day10_4pm_control	2	3960518	3927216	33302	0	0	0	0	0	0	0	0	0	0	0	0	3927216	0	0	3690696	3377279	2356809	2551421	236520	2451984	0	868980	56315	236520
B03	leaf_2	B73	day9_4pm_cold	3	41612	39309	2303	0	0	0	0	0	0	0	0	0	0	0	0	39309	0	0	24337	18060	9973	12585	14972	13080	0	4644	336	14972
B04	leaf_2	B73	day11_11am_cold	2	4078882	4025483	53399	0	0	0	0	0	0	0	0	0	0	0	0	4025483	0	0	3824885	3440701	2376635	2624256	200598	2468222	0	914984	57495	200598
B05	leaf_2	B73	day11_4pm_control	2	4616867	4584358	32509	0	0	0	0	0	0	0	0	0	0	0	0	4584358	0	0	4423155	4136968	2908550	3098463	161203	3143394	0	921783	71791	161203
B06	leaf_2	B73	day15_4pm_control	2	3464293	3431076	33217	0	0	0	0	0	0	0	0	0	0	0	0	3431076	0	0	3317115	3160344	2199834	2302642	113961	2466067	0	626226	68051	113961
B07	leaf_3	B73	day15_4pm_control	2	5186969	5140842	46127	0	0	0	0	0	0	0	0	0	0	0	0	5140842	0	0	4804532	4585243	3178177	3312310	336310	3440179	0	1043428	101636	336310
B08	leaf_2	Mo17	day9_11am_control	1	4024686	3938773	85913	0	0	0	0	0	0	0	0	0	0	0	0	3938773	0	0	3517536	3143167	1481881	1673392	421237	2330754	0	752474	59939	421237
B09	leaf_2	B73	day11_4pm_cold	2	4049331	4012352	36979	0	0	0	0	0	0	0	0	0	0	0	0	4012352	0	0	3841610	3591001	2509657	2670146	170742	2732754	0	774696	83551	170742
B10	leaf_2	Mo17	day11_11am_control	1	4406214	4368906	37308	0	0	0	0	0	0	0	0	0	0	0	0	4368906	0	0	3938040	3581981	1667705	1842113	430866	2710752	0	806085	65144	430866
B11	leaf_2	Mo17	day11_4pm_control	1	4273502	4232531	40971	0	0	0	0	0	0	0	0	0	0	0	0	4232531	0	0	3829159	3488975	1624015	1785286	403372	2477354	0	950036	61585	403372
B12	leaf_2	Mo17	day9_4pm_cold	1	7194192	7143561	50631	0	0	0	0	0	0	0	0	0	0	0	0	7143561	0	0	6421691	5516534	2585665	3067060	721870	4001015	0	1415921	99598	721870
C01	leaf_2	Mo17	day9_11am_control	2	5706730	5628176	78554	0	0	0	0	0	0	0	0	0	0	0	0	5628176	0	0	4750543	4235726	1974285	2205555	877633	3042296	0	1109535	83895	877633
C02	leaf_2	Mo17	day10_4pm_control	1	1930380	1893846	36534	0	0	0	0	0	0	0	0	0	0	0	0	1893846	0	0	1588574	1219864	566732	765290	305272	906973	0	289300	23591	305272
C03	leaf_2	Mo17	day9_4pm_cold	2	1456110	1434610	21500	0	0	0	0	0	0	0	0	0	0	0	0	1434610	0	0	1244829	1152532	544429	587036	189781	876307	0	253357	22868	189781
C04	leaf_2	Mo17	day11_11am_cold	1	1471538	1434476	37062	0	0	0	0	0	0	0	0	0	0	0	0	1434476	0	0	1282174	1072981	485008	596343	152302	780547	0	270971	21463	152302
C05	leaf_2	Mo17	day12_4pm_control	1	2394103	2375213	18890	0	0	0	0	0	0	0	0	0	0	0	0	2375213	0	0	2153195	1945566	896027	1000864	222018	1431300	0	479259	35007	222018
C06	leaf_2	Mo17	day15_4pm_control	1	4014333	3903843	110490	0	0	0	0	0	0	0	0	0	0	0	0	3903843	0	0	3542108	3229056	1445743	1609254	361735	2395746	0	760970	72340	361735
C07	leaf_3	Mo17	day15_4pm_control	1	5817331	5705250	112081	0	0	0	0	0	0	0	0	0	0	0	0	5705250	0	0	5211434	4745009	2155173	2396346	493816	3484049	0	1162672	98288	493816
C08	leaf_2	B73	day9_12pm_control	1	4963085	4928482	34603	0	0	0	0	0	0	0	0	0	0	0	0	4928482	0	0	4696366	4235070	2982001	3276265	232116	3083161	0	1076895	75014	232116
C09	leaf_2	Mo17	day11_4pm_cold	1	3380876	3353930	26946	0	0	0	0	0	0	0	0	0	0	0	0	3353930	0	0	2998947	2758016	1273521	1388505	354983	2061612	0	632634	63770	354983
C10	leaf_2	B73	day11_11am_cold	3	4440669	4409604	31065	0	0	0	0	0	0	0	0	0	0	0	0	4409604	0	0	4229413	3910139	2720102	2933049	180191	2881222	0	954904	74013	180191
C11	leaf_2	B73	day11_4pm_cold	3	8404865	8340323	64542	0	0	0	0	0	0	0	0	0	0	0	0	8340323	0	0	8091807	7623464	5350581	5664010	248516	5851535	0	1611162	160767	248516
C12	leaf_2	B73	day15_4pm_control	3	4349542	4315602	33940	0	0	0	0	0	0	0	0	0	0	0	0	4315602	0	0	4091787	3987619	2759533	2827145	223815	3104802	0	786829	95988	223815
D01	leaf_2	Mo17	day9_11am_control	3	3340530	3309006	31524	0	0	0	0	0	0	0	0	0	0	0	0	3309006	0	0	2859978	2527078	1179909	1343664	449028	1849955	0	626395	50728	449028
D02	leaf_2	Mo17	day10_4pm_control	2	3606988	3545624	61364	0	0	0	0	0	0	0	0	0	0	0	0	3545624	0	0	3096990	2777192	1289335	1444865	448634	2004559	0	720550	52083	448634
D03	leaf_2	Mo17	day9_4pm_cold	3	375539	361653	13886	0	0	0	0	0	0	0	0	0	0	0	0	361653	0	0	204301	103831	50894	102076	157352	73122	0	28643	2066	157352
D04	leaf_2	Mo17	day11_11am_cold	2	3091189	3070057	21132	0	0	0	0	0	0	0	0	0	0	0	0	3070057	0	0	2743224	2452005	1137305	1289236	326833	1787862	0	620543	43600	326833
D05	leaf_2	Mo17	day12_4pm_control	2	6016519	5947383	69136	0	0	0	0	0	0	0	0	0	0	0	0	5947383	0	0	5368473	4914021	2224765	2441228	578910	3541289	0	1282956	89776	578910
D06	leaf_2	Mo17	day15_4pm_control	2	3450487	3393991	56496	0	0	0	0	0	0	0	0	0	0	0	0	3393991	0	0	3097431	2797633	1244481	1403993	296560	2124269	0	614344	59020	296560
D07	leaf_3	Mo17	day15_4pm_control	2	2948319	2915500	32819	0	0	0	0	0	0	0	0	0	0	0	0	2915500	0	0	2620714	2388493	1097869	1214726	294786	1734209	0	603772	50512	294786
D08	leaf_2	B73	day9_12pm_cold	1	3889598	3862459	27139	0	0	0	0	0	0	0	0	0	0	0	0	3862459	0	0	3729857	3353944	2362928	2615813	132602	2513739	0	783023	57182	132602
D09	leaf_2	Mo17	day11_4pm_cold	2	3841380	3792729	48651	0	0	0	0	0	0	0	0	0	0	0	0	3792729	0	0	3400606	3090526	1414345	1568710	392123	2307065	0	709914	73547	392123
D10	leaf_2	Mo17	day11_11am_cold	3	5819246	5778990	40256	0	0	0	0	0	0	0	0	0	0	0	0	5778990	0	0	5168130	4550127	2113741	2432589	610860	3282337	0	1174082	93708	610860
D11	leaf_2	Mo17	day11_4pm_cold	3	7712596	7658430	54166	0	0	0	0	0	0	0	0	0	0	0	0	7658430	0	0	6938645	6256492	2883350	3243167	719785	4709795	0	1413304	133393	719785
D12	leaf_2	Mo17	day15_4pm_control	3	3256337	3218233	38104	0	0	0	0	0	0	0	0	0	0	0	0	3218233	0	0	2876501	2681137	1183829	1276825	341732	2028607	0	598392	54138	341732
E01	leaf_2	B73	day9_4pm_control	1	3856322	3765327	90995	0	0	0	0	0	0	0	0	0	0	0	0	3765327	0	0	3468546	3126620	2138755	2346017	296781	2233461	0	840499	52660	296781
E02	leaf_2	B73	day10_4pm_cold	1	4255911	4189337	66574	0	0	0	0	0	0	0	0	0	0	0	0	4189337	0	0	3676187	2778616	1880897	2416171	513150	2036310	0	693941	48365	513150
E03	leaf_2	B73	day10_4pm_control	3	4307087	4277919	29168	0	0	0	0	0	0	0	0	0	0	0	0	4277919	0	0	4161555	3850923	2695600	2908241	116364	2849351	0	941420	60152	116364
E04	leaf_2	B73	day11_4pm_control	3	2772689	2749042	23647	0	0	0	0	0	0	0	0	0	0	0	0	2749042	0	0	2660635	2473447	1719028	1844015	88407	1864089	0	571075	38283	88407
E05	leaf_2	B73	day12_4pm_cold	1	4659906	4632635	27271	0	0	0	0	0	0	0	0	0	0	0	0	4632635	0	0	4485133	4172873	2909073	3118295	147502	3084741	0	1018958	69174	147502
E06	leaf_2	B73	day15_4pm_cold	1	1545614	1528131	17483	0	0	0	0	0	0	0	0	0	0	0	0	1528131	0	0	1411179	1218248	833180	950496	116952	916231	0	278299	23718	116952
E07	leaf_3	B73	day15_4pm_cold	1	6067208	6023853	43355	0	0	0	0	0	0	0	0	0	0	0	0	6023853	0	0	5844684	5630305	3951654	4099056	179169	4175764	0	1352780	101761	179169
E08	leaf_2	B73	day9_2pm_control	1	3568454	3545135	23319	0	0	0	0	0	0	0	0	0	0	0	0	3545135	0	0	3453809	3070674	2162965	2425272	91326	2256317	0	768339	46018	91326
E09	leaf_2	B73	day11_11am_control	2	4857996	4821105	36891	0	0	0	0	0	0	0	0	0	0	0	0	4821105	0	0	4687475	4348209	3052085	3281397	133630	3344032	0	928001	76176	133630
E10	leaf_2	B73	day11_12pm_control	1	4146377	4119434	26943	0	0	0	0	0	0	0	0	0	0	0	0	4119434	0	0	4017320	3707862	2600026	2811050	102114	2820110	0	833425	54327	102114
E11	leaf_2	B73	day12_4pm_control	2	5294487	5240230	54257	0	0	0	0	0	0	0	0	0	0	0	0	5240230	0	0	5139247	4818361	3366774	3588029	100983	3682949	0	1055575	79837	100983
E12	leaf_2	B73	day15_4pm_cold	2	3325422	3297318	28104	0	0	0	0	0	0	0	0	0	0	0	0	3297318	0	0	3121582	2914619	2023321	2148407	175736	2141439	0	720575	52605	175736
F01	leaf_2	B73	day9_4pm_control	2	3648646	3617097	31549	0	0	0	0	0	0	0	0	0	0	0	0	3617097	0	0	3404897	3067526	2078616	2287129	212200	2199351	0	815547	52628	212200
F02	leaf_2	B73	day10_4pm_cold	2	5111614	5051754	59860	0	0	0	0	0	0	0	0	0	0	0	0	5051754	0	0	4740835	4261814	2947181	3241093	310919	3000051	0	1194003	67760	310919
F03	leaf_2	Mo17	day10_4pm_control	3	4159601	4130939	28662	0	0	0	0	0	0	0	0	0	0	0	0	4130939	0	0	3683014	3338776	1592316	1760511	447925	2415783	0	861056	61937	447925
F04	leaf_2	B73	day11_4pm_control	4	5055582	5021911	33671	0	0	0	0	0	0	0	0	0	0	0	0	5021911	0	0	4897682	4597878	3238547	3444357	124229	3485058	0	1038035	74785	124229
F05	leaf_2	B73	day12_4pm_cold	2	6826258	6779838	46420	0	0	0	0	0	0	0	0	0	0	0	0	6779838	0	0	6624236	6240263	4354262	4618427	155602	4697067	0	1435303	107893	155602
F06	leaf_2	B73	day15_4pm_cold	3	5131163	5086982	44181	0	0	0	0	0	0	0	0	0	0	0	0	5086982	0	0	4966842	4622251	3226279	3461866	120140	3506271	0	1029308	86672	120140
F07	leaf_3	B73	day15_4pm_cold	2	3640501	3545278	95223	0	0	0	0	0	0	0	0	0	0	0	0	3545278	0	0	3387701	3220729	2232839	2340322	157577	2323905	0	836760	60064	157577
F08	leaf_2	B73	day9_2pm_cold	1	4196335	4151726	44609	0	0	0	0	0	0	0	0	0	0	0	0	4151726	0	0	3907387	3415257	2361648	2665006	244339	2537859	0	819240	58158	244339
F09	leaf_2	B73	day11_11am_control	3	2387084	2340858	46226	0	0	0	0	0	0	0	0	0	0	0	0	2340858	0	0	2231781	2062535	1416883	1524225	109077	1575971	0	449841	36723	109077
F10	leaf_2	B73	day11_12pm_cold	1	6642905	6576426	66479	0	0	0	0	0	0	0	0	0	0	0	0	6576426	0	0	6384688	5922417	4094357	4406619	191738	4411934	0	1411725	98758	191738
F11	leaf_2	Mo17	day12_4pm_control	3	8208892	8132632	76260	0	0	0	0	0	0	0	0	0	0	0	0	8132632	0	0	7332151	6699974	3060732	3363780	800481	4909920	0	1667605	122449	800481
F12	leaf_2	Mo17	day15_4pm_cold	1	5018677	4920077	98600	0	0	0	0	0	0	0	0	0	0	0	0	4920077	0	0	4048295	3693260	1644030	1795043	871782	2559308	0	1055245	78707	871782
G01	leaf_2	Mo17	day9_4pm_control	1	5366242	5311143	55099	0	0	0	0	0	0	0	0	0	0	0	0	5311143	0	0	4416742	3925861	1819542	2034769	894401	2704900	0	1144444	76517	894401
G02	leaf_2	Mo17	day10_4pm_cold	1	1816565	1785481	31084	0	0	0	0	0	0	0	0	0	0	0	0	1785481	0	0	1384986	1004218	461013	658813	400495	733425	0	249457	21336	400495
G03	leaf_2	B73	day10_4pm_cold	3	4280883	4216601	64282	0	0	0	0	0	0	0	0	0	0	0	0	4216601	0	0	3950965	3462257	2402430	2709663	265636	2520373	0	883778	58106	265636
G04	leaf_2	Mo17	day11_4pm_control	2	3694335	3638903	55432	0	0	0	0	0	0	0	0	0	0	0	0	3638903	0	0	3292563	2988969	1369731	1517921	346340	2156593	0	780067	52309	346340
G05	leaf_2	Mo17	day12_4pm_cold	1	3616756	3553247	63509	0	0	0	0	0	0	0	0	0	0	0	0	3553247	0	0	3225980	2922431	1320309	1468904	327267	2138424	0	729498	54509	327267
G06	leaf_2	Mo17	day15_4pm_cold	2	2903502	2885641	17861	0	0	0	0	0	0	0	0	0	0	0	0	2885641	0	0	2628610	2398379	1083115	1198031	257031	1754965	0	593366	50048	257031
G07	leaf_7	Mo17	day15_4pm_cold	1	5671037	5581082	89955	0	0	0	0	0	0	0	0	0	0	0	0	5581082	0	0	4957512	4564644	2034004	2214653	623570	3263245	0	1201801	99598	623570
G08	leaf_2	B73	day9_4pm_control	3	6261564	6215765	45799	0	0	0	0	0	0	0	0	0	0	0	0	6215765	0	0	6021757	5465964	3821602	4192204	194008	3959875	0	1422980	83109	194008
G09	leaf_2	Mo17	day11_11am_control	2	6955521	6899944	55577	0	0	0	0	0	0	0	0	0	0	0	0	6899944	0	0	6210493	5592572	2599786	2907984	689451	4154443	0	1328478	109651	689451
G10	leaf_2	B73	day11_2pm_control	1	5574616	5509578	65038	0	0	0	0	0	0	0	0	0	0	0	0	5509578	0	0	5325252	4930151	3406427	3663979	184326	3702120	0	1153118	74913	184326
G11	leaf_2	B73	day12_4pm_cold	3	6782374	6726813	55561	0	0	0	0	0	0	0	0	0	0	0	0	6726813	0	0	6538656	6114605	4184529	4466671	188157	4615927	0	1395730	102948	188157
H01	leaf_2	Mo17	day9_4pm_control	2	2300737	2273235	27502	0	0	0	0	0	0	0	0	0	0	0	0	2273235	0	0	1936089	1637473	766144	913284	337146	1149128	0	455919	32426	337146
H02	leaf_2	Mo17	day10_4pm_cold	2	5171073	5111456	59617	0	0	0	0	0	0	0	0	0	0	0	0	5111456	0	0	4360812	3884030	1767154	1987487	750644	2662069	0	1153238	68723	750644
H03	leaf_2	Mo17	day10_4pm_cold	3	6126041	6023066	102975	0	0	0	0	0	0	0	0	0	0	0	0	6023066	0	0	4911077	4246104	1982618	2283547	1111989	3019884	0	1139934	86286	1111989
H04	leaf_2	Mo17	day11_4pm_control	3	12630	11559	1071	0	0	0	0	0	0	0	0	0	0	0	0	11559	0	0	10302	9303	4873	5426	1257	6789	0	2367	147	1257
H05	leaf_2	Mo17	day12_4pm_cold	2	4507985	4474133	33852	0	0	0	0	0	0	0	0	0	0	0	0	4474133	0	0	4026485	3664515	1662934	1839313	447648	2663043	0	930543	70929	447648
H06	leaf_2	Mo17	day15_4pm_cold	3	2230076	2179823	50253	0	0	0	0	0	0	0	0	0	0	0	0	2179823	0	0	1937372	1646916	751926	907274	242451	1228010	0	384247	34659	242451
H07	leaf_3	Mo17	day15_4pm_cold	1	4624801	4545684	79117	0	0	0	0	0	0	0	0	0	0	0	0	4545684	0	0	3880680	3643304	1662028	1764961	665004	2595710	0	966792	80802	665004
H08	leaf_2	Mo17	day9_4pm_control	3	6638572	6581324	57248	0	0	0	0	0	0	0	0	0	0	0	0	6581324	0	0	5937116	5369383	2488333	2762152	644208	3856056	0	1411658	101669	644208
H09	leaf_2	Mo17	day11_11am_control	3	7376732	7301128	75604	0	0	0	0	0	0	0	0	0	0	0	0	7301128	0	0	6416316	5743576	2662108	2988804	884812	4283833	0	1349006	110737	884812
H10	leaf_2	B73	day11_2pm_cold	1	6619274	6423943	195331	0	0	0	0	0	0	0	0	0	0	0	0	6423943	0	0	5985152	5567532	3849141	4103442	438791	4162943	0	1274539	130050	438791
H11	leaf_2	Mo17	day12_4pm_cold	3	5581243	5515307	65936	0	0	0	0	0	0	0	0	0	0	0	0	5515307	0	0	4897271	4584835	2113115	2245920	618036	3371755	0	1133424	79656	618036
