SampleID	Tissue	Genotype	Treatment	Replicate	total	passed	failed	pair	pair_bad	pair_dup	pair_map	pair_map_hq	pair_map_hq0	pair_map0	pair_orphan	pair_orphan_hq	pair_orphan_hq0	pair_orphan0	pair_unmap	unpair	unpair_bad	unpair_dup	unpair_map	unpair_map_hq	unpair_map_hq0	unpair_map0	unpair_unmap	Assigned	Unassigned_MultiMapping	Unassigned_NoFeatures	Unassigned_Ambiguity	Unassigned_Unmapped
SRR1619633	leaf	B73	6DAP_pol	1	16696527	15196245	1500282	0	0	0	0	0	0	0	0	0	0	0	0	15196245	0	0	14442290	13668931	9144343	9646009	753955	12443762	0	1064163	161006	753955
SRR1619634	leaf	B73	6DAP_pol	2	22282272	20169550	2112722	0	0	0	0	0	0	0	0	0	0	0	0	20169550	0	0	19169724	18108879	12001518	12688768	999826	16493440	0	1410279	205160	999826
SRR1619635	leaf	B73	6DAP_nopol	1	88484095	85279121	3204974	0	0	0	0	0	0	0	0	0	0	0	0	85279121	0	0	78990457	74771270	59356155	62651151	6288664	68589745	0	5321409	860116	6288664
SRR1619636	leaf	B73	12DAP_pol	1	62489080	61254554	1234526	0	0	0	0	0	0	0	0	0	0	0	0	61254554	0	0	55919332	53049069	39998375	42119708	5335222	48553098	0	3857596	638375	5335222
SRR1619637	leaf	B73	12DAP_pol	2	11236192	10234444	1001748	0	0	0	0	0	0	0	0	0	0	0	0	10234444	0	0	9833422	9286041	6141531	6492703	401022	8476856	0	696909	112276	401022
SRR1619638	leaf	B73	12DAP_nopol	1	18383571	16808315	1575256	0	0	0	0	0	0	0	0	0	0	0	0	16808315	0	0	16168486	15283956	10233138	10809129	639829	13908351	0	1191379	184226	639829
SRR1619659	leaf	B73	12DAP_nopol	2	17110183	15553025	1557158	0	0	0	0	0	0	0	0	0	0	0	0	15553025	0	0	14915825	14134841	9438969	9947908	637200	12877089	0	1091646	166106	637200
SRR1619660	leaf	B73	18DAP_pol	1	14559869	13138857	1421012	0	0	0	0	0	0	0	0	0	0	0	0	13138857	0	0	12437186	11716409	7650177	8105978	701671	10659496	0	913191	143722	701671
SRR1619661	leaf	B73	18DAP_pol	2	14351598	12812525	1539073	0	0	0	0	0	0	0	0	0	0	0	0	12812525	0	0	12040555	11403414	7536627	7947542	771970	10407933	0	856640	138841	771970
SRR1619662	leaf	B73	18DAP_nopol	1	15257688	13622354	1635334	0	0	0	0	0	0	0	0	0	0	0	0	13622354	0	0	12179420	11570027	7785966	8186051	1442934	10540409	0	891356	138262	1442934
SRR1619663	leaf	B73	18DAP_nopol	2	19796997	17592845	2204152	0	0	0	0	0	0	0	0	0	0	0	0	17592845	0	0	16833302	15961352	10627956	11194035	759543	14618831	0	1149661	192860	759543
SRR1619664	leaf	B73	24DAP_pol	1	17040548	15361068	1679480	0	0	0	0	0	0	0	0	0	0	0	0	15361068	0	0	13244120	12210930	8122411	8770557	2116948	11240769	0	817062	153099	2116948
SRR1619665	leaf	B73	24DAP_nopol	1	19635360	17915540	1719820	0	0	0	0	0	0	0	0	0	0	0	0	17915540	0	0	16975558	16192927	11019248	11538643	939982	14806429	0	1213151	173347	939982
SRR1619666	leaf	B73	24DAP_nopol	2	16944003	15535160	1408843	0	0	0	0	0	0	0	0	0	0	0	0	15535160	0	0	14645993	13997476	9486341	9916923	889167	12844806	0	999441	153229	889167
SRR1619667	leaf	B73	30DAP_pol	1	30686002	28115845	2570157	0	0	0	0	0	0	0	0	0	0	0	0	28115845	0	0	26252124	25028118	16730513	17534376	1863721	22937918	0	1814719	275481	1863721
SRR1619668	leaf	B73	30DAP_pol	2	31520063	28446962	3073101	0	0	0	0	0	0	0	0	0	0	0	0	28446962	0	0	26935473	25706862	16987724	17784725	1511489	23612916	0	1802314	291632	1511489
SRR1619669	leaf	B73	0DAP_pol	1	7989357	7396516	592841	0	0	0	0	0	0	0	0	0	0	0	0	7396516	0	0	7089316	6732730	4598755	4837724	307200	6190380	0	461384	80966	307200
SRR1619670	leaf	B73	0DAP_pol	2	10972648	9880920	1091728	0	0	0	0	0	0	0	0	0	0	0	0	9880920	0	0	9391110	8899226	5794402	6107723	489810	8137785	0	653926	107515	489810
SRR1619671	leaf	B73	0DAP_nopol	1	26959502	24368621	2590881	0	0	0	0	0	0	0	0	0	0	0	0	24368621	0	0	22712153	21513838	14118915	14886196	1656468	19689728	0	1567173	256937	1656468
SRR1619674	leaf	B73	0DAP_nopol	2	11636321	9753474	1882847	0	0	0	0	0	0	0	0	0	0	0	0	9753474	0	0	9185831	8560567	5223843	5589003	567643	7817723	0	640184	102660	567643
SRR1620828	internode	B73	6DAP_pol	1	5837440	4911252	926188	4911252	0	0	4546151	4376618	2073237	2148710	0	0	0	0	365101	0	0	0	0	0	0	0	0	3992342	596522	322159	62117	365101
SRR1620830	internode	B73	6DAP_pol	2	3700363	3549092	151271	3549092	0	0	3303373	3185193	2690853	2786600	0	0	0	0	245719	0	0	0	0	0	0	0	0	2916179	413186	224324	44690	245719
SRR1620835	internode	B73	6DAP_nopol	1	8134174	7237785	896389	7237785	0	0	7043211	6825908	4130980	4257519	0	0	0	0	194574	0	0	0	0	0	0	0	0	6274782	647547	460588	90538	194574
SRR1620836	internode	B73	6DAP_nopol	2	6327314	5355094	972220	5355094	0	0	5213478	5042893	2360636	2437755	0	0	0	0	141616	0	0	0	0	0	0	0	0	4612856	489668	360786	69251	141616
SRR1620837	internode	B73	6DAP_nopol	3	3945724	3807926	137798	3807926	0	0	3728475	3611374	3070633	3167823	0	0	0	0	79451	0	0	0	0	0	0	0	0	3313618	332646	248796	48960	79451
SRR1620838	internode	B73	12DAP_pol	1	8587208	7763256	823952	7763256	0	0	7260938	7040662	4442116	4570791	0	0	0	0	502318	0	0	0	0	0	0	0	0	6505460	796239	450735	84467	502318
SRR1620839	internode	B73	12DAP_pol	2	10898833	10334372	564461	10334372	0	0	10175166	9882360	7224152	7431944	0	0	0	0	159206	0	0	0	0	0	0	0	0	9150534	832320	606266	125560	159206
SRR1620841	internode	B73	12DAP_nopol	1	11515968	10931118	584850	10931118	0	0	10501796	10166290	7459569	7697089	0	0	0	0	429322	0	0	0	0	0	0	0	0	9365619	1138449	670032	130639	429322
SRR1620843	internode	B73	0DAP_pol	1	36882238	32453324	4428914	32453324	0	0	31944167	31024147	17861642	18369829	0	0	0	0	509157	0	0	0	0	0	0	0	0	28540302	2558792	2070640	413205	509157
SRR1620844	internode	B73	12DAP_nopol	2	19133008	18025154	1107854	18025154	0	0	17707021	17176818	12411988	12785089	0	0	0	0	318133	0	0	0	0	0	0	0	0	15902722	1518139	1050788	223308	318133
SRR1620846	internode	B73	18DAP_pol	1	23529767	22157836	1371931	22157836	0	0	19730774	18936334	13720320	14266083	0	0	0	0	2427062	0	0	0	0	0	0	0	0	17386670	3595699	1299693	249971	2427062
SRR1620847	internode	B73	18DAP_pol	2	16122458	15125154	997304	15125154	0	0	14334959	13822686	10100630	10461707	0	0	0	0	790195	0	0	0	0	0	0	0	0	12661349	1833572	977100	184237	790195
SRR1620849	internode	B73	18DAP_nopol	1	18171433	17174878	996555	17174878	0	0	16896029	16383232	11946550	12312110	0	0	0	0	278849	0	0	0	0	0	0	0	0	15135559	1452139	1039563	208110	278849
SRR1620898	internode	B73	18DAP_nopol	2	11174409	10563776	610633	10563776	0	0	10371905	10065663	7352876	7571317	0	0	0	0	191871	0	0	0	0	0	0	0	0	9292363	858513	650676	122624	191871
SRR1620900	internode	B73	0DAP_nopol	1	54619479	46871790	7747689	46871790	0	0	46264998	44784942	22310544	23029897	0	0	0	0	606792	0	0	0	0	0	0	0	0	40972804	4120928	3205165	606973	606792
SRR1620901	internode	B73	0DAP_nopol	2	30541394	28919105	1622289	28919105	0	0	28528491	27660097	22666016	23361271	0	0	0	0	390614	0	0	0	0	0	0	0	0	25368675	2404342	1907429	383993	390614
SRR1620903	internode	B73	24DAP_pol	1	11954204	11268813	685391	11268813	0	0	11040366	10712370	7818328	8050846	0	0	0	0	228447	0	0	0	0	0	0	0	0	9912426	953643	661270	138674	228447
SRR1620904	internode	B73	24DAP_pol	2	13958776	13235972	722804	13235972	0	0	13021181	12636398	9242939	9516800	0	0	0	0	214791	0	0	0	0	0	0	0	0	11714984	1084628	760602	160812	214791
SRR1620906	internode	B73	24DAP_nopol	1	22384729	21211306	1173423	21211306	0	0	20896639	20278553	14950635	15395671	0	0	0	0	314667	0	0	0	0	0	0	0	0	18799725	1738247	1217570	261258	314667
SRR1620907	internode	B73	24DAP_nopol	2	11811749	11034284	777465	11034284	0	0	10680786	10342544	7512112	7752173	0	0	0	0	353498	0	0	0	0	0	0	0	0	9582310	1029791	627485	132749	353498
SRR1620908	internode	B73	0DAP_nopol	3	8911899	7910596	1001303	7910596	0	0	7760324	7510237	4485653	4631949	0	0	0	0	150272	0	0	0	0	0	0	0	0	6950842	700541	467169	92226	150272
SRR1620909	internode	B73	30DAP_pol	1	13148356	12328362	819994	12328362	0	0	12043102	11672129	8503327	8766343	0	0	0	0	285260	0	0	0	0	0	0	0	0	10831196	1065007	692431	148502	285260
SRR1620910	internode	B73	30DAP_pol	2	11131619	10481272	650347	10481272	0	0	10288054	9978017	7289676	7510912	0	0	0	0	193218	0	0	0	0	0	0	0	0	9262514	880172	587856	127647	193218
SRR1620911	internode	B73	30DAP_nopol	1	27529009	25949406	1579603	25949406	0	0	25412885	24668907	18074570	18605878	0	0	0	0	536521	0	0	0	0	0	0	0	0	22918766	2154698	1468729	281412	536521
SRR1620912	internode	B73	30DAP_nopol	2	8988134	8514995	473139	8514995	0	0	8327820	8084682	4902214	5045879	0	0	0	0	187175	0	0	0	0	0	0	0	0	7501764	716284	493187	89731	187175
SRR1620913	internode	B73	6DAP_pol	3	7121763	6392821	728942	6392821	0	0	6248285	6020535	3699301	3837404	0	0	0	0	144536	0	0	0	0	0	0	0	0	5562320	666985	380925	77290	144536
SRR1620914	internode	B73	6DAP_pol	4	21868464	20774559	1093905	20774559	0	0	20154356	19483149	16569478	17126681	0	0	0	0	620203	0	0	0	0	0	0	0	0	17815852	1988111	1394506	272791	620203
SRR1620915	internode	B73	0DAP_pol	2	7594493	7175849	418644	7175849	0	0	6949809	6734639	4092151	4219036	0	0	0	0	226040	0	0	0	0	0	0	0	0	6178983	664953	469753	85903	226040
SRR1620916	root	B73	tap_Z4_7DAS	1	18273066	16822287	1450779	16822287	0	0	16206146	15778722	10399407	10672988	0	0	0	0	616141	0	0	0	0	0	0	0	0	14561949	1318462	1027678	189095	616141
SRR1620917	root	B73	cortical_3DAS	1	17057919	15475539	1582380	15475539	0	0	15033503	14694050	9583923	9798705	0	0	0	0	442036	0	0	0	0	0	0	0	0	13731751	966942	810892	151407	442036
SRR1620918	root	B73	tap_Z3_7DAS	1	14976310	13765528	1210782	13765528	0	0	13434583	13068542	8591764	8826302	0	0	0	0	330945	0	0	0	0	0	0	0	0	12141677	1045603	783039	143826	330945
SRR1620919	root	B73	tap_Z2_7DAS	1	10873179	9797804	1075375	9797804	0	0	9605690	9350839	6963888	7149624	0	0	0	0	192114	0	0	0	0	0	0	0	0	8714665	729747	534913	101261	192114
SRR1620920	root	B73	stele_3DAS	1	12191816	10950083	1241733	10950083	0	0	10761392	10492386	7819700	8015925	0	0	0	0	188691	0	0	0	0	0	0	0	0	9799703	723899	586928	105755	188691
SRR1620921	root	B73	tap_Z2_7DAS	2	9477079	8507238	969841	8507238	0	0	8333800	8110441	6017197	6179917	0	0	0	0	173438	0	0	0	0	0	0	0	0	7561503	630463	461487	87451	173438
SRR1620922	root	B73	tap_Z1_7DAS	1	16413513	15134054	1279459	15134054	0	0	13791508	13339317	8884408	9172495	0	0	0	0	1342546	0	0	0	0	0	0	0	0	12536601	2117246	652047	150669	1342546
SRR1620923	root	B73	tap_Z3_7DAS	2	11577165	10457943	1119222	10457943	0	0	10246836	9976400	7445215	7642111	0	0	0	0	211107	0	0	0	0	0	0	0	0	9298889	771661	570075	107436	211107
SRR1620924	root	B73	tap_Z3_7DAS	3	16795516	15092656	1702860	15092656	0	0	14817940	14451062	10774536	11041652	0	0	0	0	274716	0	0	0	0	0	0	0	0	13542243	1053664	740607	168212	274716
SRR1620925	root	B73	tap_Z4_7DAS	2	17843022	15779863	2063159	15779863	0	0	15094171	14694947	10821219	11107667	0	0	0	0	685692	0	0	0	0	0	0	0	0	13540146	1188648	976735	178066	685692
SRR1620926	root	B73	tap_Z4_7DAS	3	17112984	15179129	1933855	15179129	0	0	14446093	14054079	10390578	10672978	0	0	0	0	733036	0	0	0	0	0	0	0	0	12913431	1148179	972168	168480	733036
SRR1620927	leaf	B73	3-7.13	1	12913091	11591849	1321242	11591849	0	0	11026003	10419714	4615679	4882710	0	0	0	0	565846	0	0	0	0	0	0	0	0	9691164	1862069	624945	103605	565846
SRR1620928	root	B73	tap_Z2_7DAS	3	10142759	9244523	898236	9244523	0	0	8999173	8766019	5749672	5898294	0	0	0	0	245350	0	0	0	0	0	0	0	0	8207418	666730	460192	98409	245350
SRR1620929	leaf	B73	3.7.1	1	12069754	10642084	1427670	10642084	0	0	10285624	9834706	4162394	4312015	0	0	0	0	356460	0	0	0	0	0	0	0	0	9154665	1298778	583772	96269	356460
SRR1620930	leaf	B73	TC_control	1	9802466	8730013	1072453	8730013	0	0	8469501	8122219	3613387	3733838	0	0	0	0	260512	0	0	0	0	0	0	0	0	7576740	984559	465510	79969	260512
SRR1620931	root	B73	crown_node5_V7	1	39008618	33819949	5188669	33819949	0	0	32994323	32051784	16685627	17162364	0	0	0	0	825626	0	0	0	0	0	0	0	0	29670123	2950795	1988835	392826	825626
SRR1620932	root	B73	crown_node5_V7	2	55182150	52289854	2892296	52289854	0	0	50751173	49352488	40739047	41868402	0	0	0	0	1538681	0	0	0	0	0	0	0	0	45795861	4504517	2948916	607711	1538681
SRR1620933	root	B73	tap_Z1_7DAS	2	4813641	4402559	411082	4402559	0	0	4289107	4170167	2749542	2826294	0	0	0	0	113452	0	0	0	0	0	0	0	0	3922281	330556	203653	44233	113452
SRR1620934	root	B73	tap_Z1_7DAS	3	15242142	14464105	778037	14464105	0	0	14139825	13750625	11940504	12275019	0	0	0	0	324280	0	0	0	0	0	0	0	0	12922150	1085998	681660	146815	324280
SRR1620935	root	B73	tap_Z1_7DAS	4	5989240	5503400	485840	5503400	0	0	5356654	5204672	3444424	3543260	0	0	0	0	146746	0	0	0	0	0	0	0	0	4897757	426472	250873	56042	146746
SRR1620936	root	B73	tap_Z1_7DAS	5	67945693	64464118	3481575	64464118	0	0	62881420	61121676	53136039	54651039	0	0	0	0	1582698	0	0	0	0	0	0	0	0	57499594	4933285	2965716	656366	1582698
SRR1620937	root	B73	stele_3DAS	2	7268621	6701873	566748	6701873	0	0	6583318	6414822	4199185	4306552	0	0	0	0	118555	0	0	0	0	0	0	0	0	5989751	464929	357993	67078	118555
SRR1620938	root	B73	stele_3DAS	3	16908353	15616473	1291880	15616473	0	0	15331738	14935893	9852315	10108085	0	0	0	0	284735	0	0	0	0	0	0	0	0	13917108	1099441	861935	156850	284735
SRR1620939	root	B73	cortical_3DAS	2	14204831	13061187	1143644	13061187	0	0	12747101	12457513	8155888	8338877	0	0	0	0	314086	0	0	0	0	0	0	0	0	11648373	839580	681159	127981	314086
SRR1620940	root	B73	cortical_3DAS	3	20239910	18562020	1677890	18562020	0	0	18108854	17718911	11586177	11833427	0	0	0	0	453166	0	0	0	0	0	0	0	0	16653408	1148612	880355	185148	453166
SRR1620941	root	B73	primary_6DAS_GH	1	12353295	11692703	660592	11692703	0	0	11476067	11137557	5812754	5964501	0	0	0	0	216636	0	0	0	0	0	0	0	0	10490040	925003	535008	112509	216636
SRR1620942	root	B73	primary_6DAS_GH	2	8919415	8409434	509981	8409434	0	0	8224705	7982803	4157704	4264924	0	0	0	0	184729	0	0	0	0	0	0	0	0	7510582	677726	390758	81463	184729
SRR1620943	root	B73	primary_6DAS_GH	3	9110302	8620733	489569	8620733	0	0	8425551	8160644	4156364	4270256	0	0	0	0	195182	0	0	0	0	0	0	0	0	7640791	758075	436202	83651	195182
SRR1620944	meristem	B73	stem_SAM_V3	1	9807423	9305255	502168	9305255	0	0	9139674	8868496	5424060	5588163	0	0	0	0	165581	0	0	0	0	0	0	0	0	8285884	760468	477559	105053	165581
SRR1620945	meristem	B73	stem_SAM_V3	2	8565875	8090991	474884	8090991	0	0	7891074	7659395	4627908	4765631	0	0	0	0	199917	0	0	0	0	0	0	0	0	7166922	682005	401592	90881	199917
SRR1620946	meristem	B73	stem_SAM_V3	3	5994195	5670497	323698	5670497	0	0	5592855	5433788	3321863	3418097	0	0	0	0	77642	0	0	0	0	0	0	0	0	5083461	444779	285728	64599	77642
SRR1620947	leaf	B73	stage2_tip_V5	1	7543760	7081641	462119	7081641	0	0	6971859	6728620	4027091	4170824	0	0	0	0	109782	0	0	0	0	0	0	0	0	6326176	702298	325570	76874	109782
SRR1620948	leaf	B73	stage2_tip_V5	2	7971305	7500621	470684	7500621	0	0	7390454	7142842	4274428	4421103	0	0	0	0	110167	0	0	0	0	0	0	0	0	6713251	689734	344995	84596	110167
SRR1620949	leaf	B73	stage2_tip_V5	3	7330018	6883129	446889	6883129	0	0	6754964	6495149	3900155	4054073	0	0	0	0	128165	0	0	0	0	0	0	0	0	6102956	758119	318011	74182	128165
SRR1620950	seed	B73	pericarp_18DAP	1	9582408	9029302	553106	9029302	0	0	8380812	8145199	4974514	5111839	0	0	0	0	648490	0	0	0	0	0	0	0	0	7560327	907435	492882	91990	648490
SRR1620952	root	B73	diff_zone_3DAS	1	15367473	13843168	1524305	13843168	0	0	13442437	13146107	8276704	8456968	0	0	0	0	400731	0	0	0	0	0	0	0	0	12412233	892107	586566	147308	400731
SRR1620953	root	B73	7DAS	1	16288676	14667586	1621090	14667586	0	0	14083990	13740803	8649175	8857967	0	0	0	0	583596	0	0	0	0	0	0	0	0	12921349	1143866	651067	168387	583596
SRR1620954	root	B73	seminal_7DAS	1	14216359	12757172	1459187	12757172	0	0	12432168	12130210	7633826	7819907	0	0	0	0	325004	0	0	0	0	0	0	0	0	11396490	848069	598820	134900	325004
SRR1620955	root	B73	mz+ez_3DAS	1	14599437	13263388	1336049	13263388	0	0	12949147	12593171	8009808	8231965	0	0	0	0	314241	0	0	0	0	0	0	0	0	11919182	1046730	538110	135879	314241
SRR1620956	root	B73	diff_zone_3DAS	2	14567540	13117940	1449600	13117940	0	0	12671945	12375047	7820131	8002430	0	0	0	0	445995	0	0	0	0	0	0	0	0	11656862	916954	590454	127731	445995
SRR1620957	root	B73	7DAS	2	12841026	11553855	1287171	11553855	0	0	11262121	10991362	6957359	7124375	0	0	0	0	291734	0	0	0	0	0	0	0	0	10335571	774687	530124	125667	291734
SRR1620959	root	B73	primay_7DAS	1	12410932	11193448	1217484	11193448	0	0	10736320	10461653	6648932	6817650	0	0	0	0	457128	0	0	0	0	0	0	0	0	9831070	912637	508127	122456	457128
SRR1620960	root	B73	3DAS	1	16235308	14738953	1496355	14738953	0	0	14476227	14116962	9019038	9243760	0	0	0	0	262726	0	0	0	0	0	0	0	0	13311166	1013986	654942	150854	262726
SRR1620961	root	B73	3DAS	2	6824936	6142158	682778	6142158	0	0	5943596	5792279	3662922	3756797	0	0	0	0	198562	0	0	0	0	0	0	0	0	5466001	417405	264997	61281	198562
SRR1620962	root	B73	3DAS	3	401696	376306	25390	376306	0	0	362534	353637	291918	299181	0	0	0	0	13772	0	0	0	0	0	0	0	0	333692	26115	16186	3759	13772
SRR1620963	root	B73	3DAS	4	7010679	6292696	717983	6292696	0	0	6127166	5981789	3764136	3852972	0	0	0	0	165530	0	0	0	0	0	0	0	0	5654230	405887	263225	64334	165530
SRR1620965	root	B73	primay_7DAS	2	6733740	6053936	679804	6053936	0	0	5906411	5763601	3615378	3702713	0	0	0	0	147525	0	0	0	0	0	0	0	0	5407235	407724	287213	69153	147525
SRR1620966	root	B73	primay_7DAS	3	52132012	49250763	2881249	49250763	0	0	48082554	46936980	40248624	41216671	0	0	0	0	1168209	0	0	0	0	0	0	0	0	44059743	3260265	2319956	557281	1168209
SRR1620967	root	B73	seminal_7DAS	2	8107015	7351584	755431	7351584	0	0	7208496	7034979	4461143	4568620	0	0	0	0	143088	0	0	0	0	0	0	0	0	6633032	478077	320389	81558	143088
SRR1620968	root	B73	mz+ez_3DAS	2	14983712	13513712	147e4	13513712	0	0	13172012	12824337	8178387	8396581	0	0	0	0	341700	0	0	0	0	0	0	0	0	12176193	941479	514447	133697	341700
SRR1620969	root	B73	seminal_7DAS	3	29922363	27191451	2730912	27191451	0	0	23215429	22613893	14438208	14813930	0	0	0	0	3976022	0	0	0	0	0	0	0	0	21460099	1662511	905317	248477	3976022
SRR1620971	root	B73	7DAS	3	14272451	13734270	538181	13734270	0	0	13328533	13009956	11081295	11347765	0	0	0	0	405737	0	0	0	0	0	0	0	0	12213109	941590	646676	150171	405737
SRR1620972	root	B73	mz+ez_3DAS	3	5864885	5727582	137303	5727582	0	0	5603507	5450944	4533362	4658900	0	0	0	0	124075	0	0	0	0	0	0	0	0	5163676	448812	228826	58442	124075
SRR1620973	root	B73	primay_7DAS	4	41321947	39404323	1917624	39404323	0	0	38228866	37265789	31895198	32705272	0	0	0	0	1175457	0	0	0	0	0	0	0	0	34856441	2802781	1956695	452653	1175457
SRR1620974	root	B73	diff_zone_3DAS	3	3006106	2902037	104069	2902037	0	0	2796946	2730070	2258767	2312785	0	0	0	0	105091	0	0	0	0	0	0	0	0	2518509	202465	176064	35497	105091
SRR1620975	root	B73	corwn_node4_V7	1	16555706	15920641	635065	15920641	0	0	15153578	14726134	12648625	13006446	0	0	0	0	767063	0	0	0	0	0	0	0	0	13786568	1566746	768886	170680	767063
SRR1620976	root	B73	corwn_node4_V7	2	4176938	4070175	106763	4070175	0	0	3932621	3822458	3138386	3227125	0	0	0	0	137554	0	0	0	0	0	0	0	0	3572930	368032	202737	46791	137554
SRR1620977	root	B73	corwn_node4_V7	3	19641779	18451947	1189832	18451947	0	0	17858919	17359147	14264709	14666669	0	0	0	0	593028	0	0	0	0	0	0	0	0	16215700	1645633	932738	210709	593028
SRR1620987	root	B73	crown_node5_V13	1	8549104	8220951	328153	8220951	0	0	7602772	7360487	6306550	6507184	0	0	0	0	618179	0	0	0	0	0	0	0	0	6864230	1094377	407315	88942	618179
SRR1620988	root	B73	brace_node6_V13	1	23381826	22467254	914572	22467254	0	0	21715857	21154878	18253577	18730148	0	0	0	0	751397	0	0	0	0	0	0	0	0	19884723	1605607	1030881	239274	751397
SRR1620989	root	B73	crown_node1-3_V7	1	19444449	18717652	726797	18717652	0	0	17699937	17208507	14744425	15154672	0	0	0	0	1017715	0	0	0	0	0	0	0	0	16045969	1832223	956433	206105	1017715
SRR1620990	root	B73	crown_node1-3_V7	2	3720019	3623103	96916	3623103	0	0	3444190	3345037	2743729	2823380	0	0	0	0	178913	0	0	0	0	0	0	0	0	3113412	341272	190420	41205	178913
SRR1620991	root	B73	crown_node1-3_V7	3	5572405	5282420	289985	5282420	0	0	5026765	4883011	4031965	4147682	0	0	0	0	255655	0	0	0	0	0	0	0	0	4543325	487994	280610	59076	255655
SRR1620992	root	B73	corwn_node4_V7	4	4433906	4299758	134148	4299758	0	0	4179992	4067932	3285918	3374917	0	0	0	0	119766	0	0	0	0	0	0	0	0	3794955	327209	226435	46542	119766
SRR1621013	root	B73	corwn_node4_V7	5	2842013	2688632	153381	2688632	0	0	2618829	2548750	2105702	2162642	0	0	0	0	69803	0	0	0	0	0	0	0	0	2376586	203199	143707	28457	69803
SRR1621014	root	B73	brace_node6_V13	2	2355744	2293999	61745	2293999	0	0	2236711	2176231	1801777	1851448	0	0	0	0	57288	0	0	0	0	0	0	0	0	2051976	170498	100611	23644	57288
SRR1621015	root	B73	brace_node6_V13	3	5143150	4846899	296251	4846899	0	0	4736090	4607925	3827157	3932496	0	0	0	0	110809	0	0	0	0	0	0	0	0	4345357	357886	213704	48864	110809
SRR1621016	root	B73	crown_node5_V13	2	32719086	31659173	1059913	31659173	0	0	30780116	29998158	24516333	25143470	0	0	0	0	879057	0	0	0	0	0	0	0	0	28153239	2280282	1482588	362331	879057
SRR1621017	root	B73	brace_node6_V13	4	12995401	11999723	995678	11999723	0	0	11755114	11438740	7551686	7756967	0	0	0	0	244609	0	0	0	0	0	0	0	0	10763677	883650	543808	131255	244609
SRR1621018	root	B73	crown_node5_V13	3	8933322	8256597	676725	8256597	0	0	8005849	7785793	5143423	5284625	0	0	0	0	250748	0	0	0	0	0	0	0	0	7277128	677319	416976	91689	250748
SRR1621019	root	B73	crown_node5_V7	3	11322911	10412355	910556	10412355	0	0	9970259	9687394	6343729	6522230	0	0	0	0	442096	0	0	0	0	0	0	0	0	9086741	961544	483827	116826	442096
SRR1626419	leaf	B73	6DAP_nopol	2	11236503	10765875	470628	0	0	0	0	0	0	0	0	0	0	0	0	10765875	0	0	10122051	9575081	7312933	7722316	643824	8764962	0	698139	111980	643824
SRR1626426	leaf	B73	24DAP_pol	2	11507287	11043931	463356	0	0	0	0	0	0	0	0	0	0	0	0	11043931	0	0	10334359	9875525	7543592	7887149	709572	9112825	0	650693	112007	709572
SRR1626427	leaf	B73	30DAP_nopol	1	11914387	11250429	663958	0	0	0	0	0	0	0	0	0	0	0	0	11250429	0	0	8584050	8206124	6302741	6581704	2666379	7441776	0	678919	85429	2666379
SRR1626452	leaf	B73	30DAP_nopol	2	13178107	12687957	490150	0	0	0	0	0	0	0	0	0	0	0	0	12687957	0	0	9815673	9390830	7201017	7513963	2872284	8540904	0	751965	97961	2872284
SRR1633397	root	B73	3DAS	5	7977374	7453566	523808	7453566	0	0	7263871	7095976	5832126	5967804	0	0	0	0	189695	0	0	0	0	0	0	0	0	6707408	468626	313038	75530	189695
SRR404131	seed	B73	germinating_24H	1	16664335	16164572	499763	0	0	0	0	0	0	0	0	0	0	0	0	16164572	0	0	15031784	12887996	11626290	13557226	1132788	11589900	0	1149907	148189	1132788
SRR404132	seed	B73	germinating_24H	2	24401889	23600916	800973	0	0	0	0	0	0	0	0	0	0	0	0	23600916	0	0	20767829	19479175	17474849	18607716	2833087	17585110	0	1664784	229281	2833087
SRR404139	seed	B73	germinating_24H	3	16403718	14038432	2365286	0	0	0	0	0	0	0	0	0	0	0	0	14038432	0	0	12468138	11716387	8455229	8987158	1570294	10604406	0	969199	142782	1570294
SRR404140	seed	B73	germinating_24H	4	14478260	12039771	2438489	0	0	0	0	0	0	0	0	0	0	0	0	12039771	0	0	11195597	10468219	6587756	7040180	844174	9465736	0	887192	115291	844174
SRR404141	root	B73	primary_6DAS_GH	4	15385969	15047267	338702	0	0	0	0	0	0	0	0	0	0	0	0	15047267	0	0	14153143	11866445	10334734	12323219	894124	10798904	0	938138	129403	894124
SRR404142	root	B73	primary_6DAS_GH	5	30874768	28874626	2000142	0	0	0	0	0	0	0	0	0	0	0	0	28874626	0	0	25977454	24296353	19713597	21016603	2897172	22386681	0	1631260	278412	2897172
SRR404143	root	B73	primary_6DAS_GH	6	15454859	13063615	2391244	0	0	0	0	0	0	0	0	0	0	0	0	13063615	0	0	12058706	11265373	7886491	8417696	1004909	10312595	0	825966	126812	1004909
SRR404144	root	B73	primary_6DAS_GH	7	18733352	16133541	2599811	0	0	0	0	0	0	0	0	0	0	0	0	16133541	0	0	14498475	13525768	9638729	10298150	1635066	12396000	0	976135	153633	1635066
SRR404145	meristem	B73	stem_SAM_V3	4	15762571	15411010	351561	0	0	0	0	0	0	0	0	0	0	0	0	15411010	0	0	14945730	12649343	11503200	13590542	465280	11532094	0	950140	167109	465280
SRR404146	meristem	B73	stem_SAM_V3	5	29955323	28200237	1755086	0	0	0	0	0	0	0	0	0	0	0	0	28200237	0	0	24353497	22847831	20147499	21461286	3846740	21063445	0	1465968	318418	3846740
SRR404147	meristem	B73	stem_SAM_V3	6	16308033	13662515	2645518	0	0	0	0	0	0	0	0	0	0	0	0	13662515	0	0	12883996	12064165	9341093	9972013	778519	11051047	0	852723	160395	778519
SRR404148	meristem	B73	stem_SAM_V3	7	17778966	15495602	2283364	0	0	0	0	0	0	0	0	0	0	0	0	15495602	0	0	14662694	13753007	11116305	11847103	832908	12610749	0	954859	187399	832908
SRR404149	leaf	B73	stage2_tip_V5	4	15553296	15125174	428122	0	0	0	0	0	0	0	0	0	0	0	0	15125174	0	0	14658311	12416391	11219912	13237516	466863	11276451	0	971487	168453	466863
SRR404150	leaf	B73	stage2_tip_V5	5	30841269	28801768	2039501	0	0	0	0	0	0	0	0	0	0	0	0	28801768	0	0	26444512	24404291	21329656	23100296	2357256	22462630	0	1586030	355631	2357256
SRR404152	leaf	B73	stage2_tip_V5	6	17005539	14720696	2284843	0	0	0	0	0	0	0	0	0	0	0	0	14720696	0	0	14112329	13147501	10562433	11329289	608367	12053493	0	911634	182374	608367
SRR404153	leaf	B73	stage2_tip_V5	7	20466510	18840793	1625717	0	0	0	0	0	0	0	0	0	0	0	0	18840793	0	0	17504834	16319401	13938572	14943927	1335959	15183731	0	912786	222884	1335959
SRR404154	leaf	B73	8_V9	1	6281183	6144061	137122	0	0	0	0	0	0	0	0	0	0	0	0	6144061	0	0	5828974	5331782	4262306	4654333	315087	4911465	0	356212	64105	315087
SRR404155	leaf	B73	8_V9	2	5976811	5836317	140494	0	0	0	0	0	0	0	0	0	0	0	0	5836317	0	0	5599969	5191526	4118240	4438700	236348	4796865	0	333177	61484	236348
SRR404156	leaf	B73	8_V9	3	12990824	12559854	430970	0	0	0	0	0	0	0	0	0	0	0	0	12559854	0	0	12142373	11339059	8883568	9507042	417481	10518586	0	679839	140634	417481
SRR404158	leaf	B73	11_V9	1	6853056	6664619	188437	0	0	0	0	0	0	0	0	0	0	0	0	6664619	0	0	6365234	5914460	5239902	5637320	299385	5489806	0	354391	70263	299385
SRR404159	leaf	B73	11_V9	2	6148825	5972337	176488	0	0	0	0	0	0	0	0	0	0	0	0	5972337	0	0	5817515	5456627	4850189	5170184	154822	5043837	0	347865	64925	154822
SRR404160	leaf	B73	11_V9	3	5237785	5087253	150532	0	0	0	0	0	0	0	0	0	0	0	0	5087253	0	0	4882377	4560309	4045002	4329601	204876	4217849	0	289946	52514	204876
SRR404161	leaf	B73	13_V9	1	7441312	7135822	305490	0	0	0	0	0	0	0	0	0	0	0	0	7135822	0	0	6855753	6411410	5392022	5763205	280069	5923364	0	409112	78934	280069
SRR404162	leaf	B73	13_V9	2	7347443	7058636	288807	0	0	0	0	0	0	0	0	0	0	0	0	7058636	0	0	6772240	6347991	5320381	5673676	286396	5855735	0	413345	78911	286396
SRR404163	leaf	B73	13_V9	3	6203365	5988519	214846	0	0	0	0	0	0	0	0	0	0	0	0	5988519	0	0	5741335	5366620	4585571	4904565	247184	4947223	0	354409	64988	247184
SRR404164	leaf	B73	immature_V9	1	4816974	3380738	1436236	0	0	0	0	0	0	0	0	0	0	0	0	3380738	0	0	3191417	2992382	1637090	1746670	189321	2715356	0	235942	41084	189321
SRR404171	leaf	B73	immature_V9	2	5512159	3912868	1599291	0	0	0	0	0	0	0	0	0	0	0	0	3912868	0	0	3698414	3473217	1900666	2024745	214454	3150740	0	275689	46788	214454
SRR404172	leaf	B73	immature_V9	3	4745872	3480085	1265787	0	0	0	0	0	0	0	0	0	0	0	0	3480085	0	0	3324403	3118450	1734385	1849368	155682	2832905	0	244741	40804	155682
SRR404173	leaf	B73	13_VT	1	7142159	6803251	338908	0	0	0	0	0	0	0	0	0	0	0	0	6803251	0	0	6226197	5592842	4786382	5325157	577054	5145183	0	378593	69066	577054
SRR404174	leaf	B73	13_VT	2	6645797	6299457	346340	0	0	0	0	0	0	0	0	0	0	0	0	6299457	0	0	5627034	5050640	4328532	4818502	672423	4617307	0	371996	61337	672423
SRR404175	leaf	B73	13_VT	3	6041944	5765351	276593	0	0	0	0	0	0	0	0	0	0	0	0	5765351	0	0	5367736	5013498	4250045	4547853	397615	4642146	0	312358	58994	397615
SRR404176	leaf	B73	13_R2	1	7493245	7156815	336430	0	0	0	0	0	0	0	0	0	0	0	0	7156815	0	0	6838660	6401689	5133156	5480822	318155	5927947	0	395531	78211	318155
SRR404177	leaf	B73	13_R2	2	9768776	9361109	407667	0	0	0	0	0	0	0	0	0	0	0	0	9361109	0	0	8468060	7946369	6312778	6723523	893049	7418323	0	432358	95688	893049
SRR404178	leaf	B73	13_R2	3	6548250	6304687	243563	0	0	0	0	0	0	0	0	0	0	0	0	6304687	0	0	5990333	5595849	4522460	4838496	314354	5183660	0	344593	67596	314354
SRR404179	seed	B73	10DAP	1	12265519	11894752	370767	0	0	0	0	0	0	0	0	0	0	0	0	11894752	0	0	11639906	11138834	7772288	8114402	254846	10308154	0	679410	151270	254846
SRR404180	seed	B73	10DAP	2	9281333	8958269	323064	0	0	0	0	0	0	0	0	0	0	0	0	8958269	0	0	8768008	8384272	5848284	6110989	190261	7773811	0	501110	109351	190261
SRR404181	seed	B73	10DAP	3	7448933	7192535	256398	0	0	0	0	0	0	0	0	0	0	0	0	7192535	0	0	7009161	6700163	4670099	4881391	183374	6205041	0	408010	87112	183374
SRR404182	seed	B73	12DAP	1	5658898	5446709	212189	0	0	0	0	0	0	0	0	0	0	0	0	5446709	0	0	5188917	4939255	3467907	3638313	257792	4622855	0	259224	57176	257792
SRR404183	seed	B73	12DAP	2	4259218	4131294	127924	0	0	0	0	0	0	0	0	0	0	0	0	4131294	0	0	4012841	3819601	2669082	2801158	118453	3566909	0	207453	45239	118453
SRR404184	seed	B73	12DAP	3	7816147	7571440	244707	0	0	0	0	0	0	0	0	0	0	0	0	7571440	0	0	7333027	6966953	4866822	5117136	238413	6494814	0	389287	82852	238413
SRR404185	endosperm	B73	12DAP	1	4946871	4782217	164654	0	0	0	0	0	0	0	0	0	0	0	0	4782217	0	0	4632597	4395055	3052363	3214277	149620	4144845	0	204339	45871	149620
SRR404186	endosperm	B73	12DAP	2	6803145	6584881	218264	0	0	0	0	0	0	0	0	0	0	0	0	6584881	0	0	6335998	6008119	4176072	4398568	248883	5660741	0	284831	62547	248883
SRR404187	endosperm	B73	12DAP	3	17124858	16574668	550190	0	0	0	0	0	0	0	0	0	0	0	0	16574668	0	0	15936407	15114245	10560479	11123150	638261	14250115	0	710100	154030	638261
SRR404188	seed	B73	14DAP	1	14145375	13742125	403250	0	0	0	0	0	0	0	0	0	0	0	0	13742125	0	0	13400371	12702992	8847554	9322730	341754	11872809	0	688316	141867	341754
SRR404189	seed	B73	14DAP	2	9127755	8889986	237769	0	0	0	0	0	0	0	0	0	0	0	0	8889986	0	0	8682303	8251069	5770365	6065380	207683	7730700	0	425862	94507	207683
SRR404190	seed	B73	14DAP	3	6595254	6412556	182698	0	0	0	0	0	0	0	0	0	0	0	0	6412556	0	0	6257682	5921455	4139600	4369668	154874	5525750	0	326574	69131	154874
SRR404191	endosperm	B73	14DAP	1	8827468	8566769	260699	0	0	0	0	0	0	0	0	0	0	0	0	8566769	0	0	8333661	7860279	5497767	5820685	233108	7371394	0	400569	88316	233108
SRR404192	endosperm	B73	14DAP	2	12969341	12588967	380374	0	0	0	0	0	0	0	0	0	0	0	0	12588967	0	0	12294601	11654652	8117654	8554114	294366	10970213	0	566799	117640	294366
SRR404193	endosperm	B73	14DAP	3	13077755	12573348	504407	0	0	0	0	0	0	0	0	0	0	0	0	12573348	0	0	12297369	11606502	8086698	8558405	275979	10869612	0	601364	135526	275979
SRR404194	seed	B73	16DAP	1	10536472	10199245	337227	0	0	0	0	0	0	0	0	0	0	0	0	10199245	0	0	9885675	9289006	6437768	6843364	313570	8563728	0	603138	122140	313570
SRR404195	seed	B73	16DAP	2	6610645	6362201	248444	0	0	0	0	0	0	0	0	0	0	0	0	6362201	0	0	5871816	5500240	3825900	4076629	490385	5065063	0	360804	74373	490385
SRR404196	seed	B73	16DAP	3	10044624	9738433	306191	0	0	0	0	0	0	0	0	0	0	0	0	9738433	0	0	9512780	9006048	6256522	6601568	225653	8365732	0	534438	105878	225653
SRR404197	endosperm	B73	16DAP	1	4626754	3290005	1336749	0	0	0	0	0	0	0	0	0	0	0	0	3290005	0	0	3136184	2858611	1827358	2001500	153821	2597162	0	221745	39704	153821
SRR404198	endosperm	B73	16DAP	2	5618126	3920664	1697462	0	0	0	0	0	0	0	0	0	0	0	0	3920664	0	0	3689664	3354783	2149200	2356130	231e3	3049585	0	256532	48666	231000
SRR404199	endosperm	B73	16DAP	3	6025148	4270702	1754446	0	0	0	0	0	0	0	0	0	0	0	0	4270702	0	0	4088795	3780455	2405689	2597774	181907	3492505	0	244504	43446	181907
SRR404200	embryo	B73	16DAP	1	5669791	4068239	1601552	0	0	0	0	0	0	0	0	0	0	0	0	4068239	0	0	3902367	3661624	2430163	2589144	165872	3383318	0	236048	42258	165872
SRR404202	embryo	B73	16DAP	2	3815078	2684245	1130833	0	0	0	0	0	0	0	0	0	0	0	0	2684245	0	0	2557338	2400275	1582602	1685546	126907	2215053	0	156081	29141	126907
SRR404203	embryo	B73	16DAP	3	7285901	5117630	2168271	0	0	0	0	0	0	0	0	0	0	0	0	5117630	0	0	4770147	4473978	2911757	3102279	347483	4122642	0	298482	52854	347483
SRR531200	coleoptile	B73	6DAS_GH	1	18637142	18028640	608502	0	0	0	0	0	0	0	0	0	0	0	0	18028640	0	0	17193406	16280403	10177440	10710948	835234	15144331	0	948305	187767	835234
SRR531201	coleoptile	B73	6DAS_GH	2	4048364	3745212	303152	0	0	0	0	0	0	0	0	0	0	0	0	3745212	0	0	3668169	3481818	2466502	2592431	77043	3250814	0	191340	39664	77043
SRR531202	coleoptile	B73	6DAS_GH	3	47430414	45830482	1599932	0	0	0	0	0	0	0	0	0	0	0	0	45830482	0	0	44782318	42501740	27428436	28826505	1048164	39716648	0	2284143	500949	1048164
SRR531203	coleoptile	B73	6DAS_GH	4	3617077	3346480	270597	0	0	0	0	0	0	0	0	0	0	0	0	3346480	0	0	3226471	3054136	2070611	2180617	120009	2839723	0	180251	34162	120009
SRR531204	coleoptile	B73	6DAS_GH	5	54094364	52269680	1824684	0	0	0	0	0	0	0	0	0	0	0	0	52269680	0	0	50182877	47496893	29419757	30978479	2086803	44224557	0	2712978	559358	2086803
SRR531205	leaf	B73	pooled_V1	1	1386828	1260898	125930	0	0	0	0	0	0	0	0	0	0	0	0	1260898	0	0	1230856	1152568	873099	931811	30042	1068686	0	69954	13928	30042
SRR531206	leaf	B73	pooled_V1	2	16485683	15822703	662980	0	0	0	0	0	0	0	0	0	0	0	0	15822703	0	0	15346410	14375010	9988671	10654927	476293	13385407	0	816548	173055	476293
SRR531207	leaf	B73	pooled_V1	3	1048414	956130	92284	0	0	0	0	0	0	0	0	0	0	0	0	956130	0	0	939602	881261	671439	715299	16528	817795	0	52794	10672	16528
SRR531208	leaf	B73	pooled_V1	4	12176653	11691231	485422	0	0	0	0	0	0	0	0	0	0	0	0	11691231	0	0	11455557	10744867	7491099	7980290	235674	10013669	0	600324	130874	235674
SRR531209	leaf	B73	pooled_V1	5	646901	589875	57026	0	0	0	0	0	0	0	0	0	0	0	0	589875	0	0	568965	525842	399649	431605	20910	487420	0	31940	6482	20910
SRR531210	leaf	B73	pooled_V1	6	7834489	7521971	312518	0	0	0	0	0	0	0	0	0	0	0	0	7521971	0	0	7237866	6681062	4646205	5026204	284105	6215410	0	384160	81492	284105
SRR531211	meristem	B73	stem_SAM_V1	1	2625210	2434445	190765	0	0	0	0	0	0	0	0	0	0	0	0	2434445	0	0	2380588	2267167	1758842	1846508	53857	2107824	0	131289	28054	53857
SRR531212	meristem	B73	stem_SAM_V1	2	28802689	27836821	965868	0	0	0	0	0	0	0	0	0	0	0	0	27836821	0	0	27143960	25860070	18238144	19132043	692861	24074442	0	1450430	335198	692861
SRR531213	meristem	B73	stem_SAM_V1	3	24442245	23387767	1054478	0	0	0	0	0	0	0	0	0	0	0	0	23387767	0	0	22530293	21420623	17935729	18852797	857474	19905288	0	1240693	274642	857474
SRR531214	meristem	B73	stem_SAM_V1	4	16415142	15758646	656496	0	0	0	0	0	0	0	0	0	0	0	0	15758646	0	0	15243259	14510500	12179830	12789752	515387	13491723	0	834617	184160	515387
SRR531215	root	B73	primary_V1	1	13974543	13381253	593290	0	0	0	0	0	0	0	0	0	0	0	0	13381253	0	0	12666874	12038393	9793725	10292894	714379	11053831	0	840203	144359	714379
SRR531216	root	B73	primary_V1	2	11034025	10551117	482908	0	0	0	0	0	0	0	0	0	0	0	0	10551117	0	0	10261731	9767475	8104697	8507877	289386	9008450	0	634346	124679	289386
SRR531217	root	B73	primary_V1	3	11281284	10782296	498988	0	0	0	0	0	0	0	0	0	0	0	0	10782296	0	0	10252068	9756704	8097017	8503057	530228	8988748	0	644806	123150	530228
SRR531218	leaf	B73	topmost_V3	1	20294092	19341977	952115	0	0	0	0	0	0	0	0	0	0	0	0	19341977	0	0	18621435	17263552	14131368	15223250	720542	16005991	0	1038502	219059	720542
SRR531219	leaf	B73	topmost_V3	2	24899410	23594815	1304595	0	0	0	0	0	0	0	0	0	0	0	0	23594815	0	0	22719395	21050987	17173515	18515917	875420	19549630	0	1238771	262586	875420
SRR531220	leaf	B73	topmost_V3	3	14039938	13153037	886901	0	0	0	0	0	0	0	0	0	0	0	0	13153037	0	0	12632569	11796426	7642753	8177425	520468	10933773	0	711737	150916	520468
SRR531221	shoot	B73	tip_V5	1	19294090	18403247	890843	0	0	0	0	0	0	0	0	0	0	0	0	18403247	0	0	17963876	17114694	11308064	11860550	439371	15842123	0	1056246	216325	439371
SRR531222	shoot	B73	tip_V5	2	10414411	9916578	497833	0	0	0	0	0	0	0	0	0	0	0	0	9916578	0	0	9037788	8575141	5656623	5952929	878790	7926975	0	538804	109362	878790
SRR531223	shoot	B73	tip_V5	3	10467670	10014929	452741	0	0	0	0	0	0	0	0	0	0	0	0	10014929	0	0	9796422	9343889	6241316	6538670	218507	8654665	0	572183	117041	218507
SRR531224	internode	B73	first_V5	1	15475550	14809362	666188	0	0	0	0	0	0	0	0	0	0	0	0	14809362	0	0	14371491	13675795	9056055	9509612	437871	12576795	0	927286	171714	437871
SRR531225	internode	B73	first_V5	2	18090539	17274887	815652	0	0	0	0	0	0	0	0	0	0	0	0	17274887	0	0	16243326	15419033	10203431	10736216	1031561	14171424	0	1050967	196642	1031561
SRR531226	internode	B73	first_V5	3	19963915	19025007	938908	0	0	0	0	0	0	0	0	0	0	0	0	19025007	0	0	18440572	17558153	11612905	12187759	584435	16114952	0	1214185	229016	584435
SRR531866	leaf	B73	stage2_base_V5	1	29212820	28027364	1185456	0	0	0	0	0	0	0	0	0	0	0	0	28027364	0	0	27318370	26056129	21953602	23008069	708994	24215141	0	1508440	332548	708994
SRR531867	leaf	B73	stage2_base_V5	2	11998817	11543968	454849	0	0	0	0	0	0	0	0	0	0	0	0	11543968	0	0	11304910	10755589	9026538	9482613	239058	9969617	0	648121	137851	239058
SRR531868	leaf	B73	stage2_base_V5	3	24421039	23517288	903751	0	0	0	0	0	0	0	0	0	0	0	0	23517288	0	0	22901320	21776964	18195476	19121087	615968	20191287	0	1307643	278034	615968
SRR531869	leaf	B73	stage2_tip_V7	1	38153537	36569767	1583770	0	0	0	0	0	0	0	0	0	0	0	0	36569767	0	0	35499874	33071665	27556339	29561734	1069893	30492112	0	2171412	408141	1069893
SRR531870	leaf	B73	stage2_tip_V7	2	25271955	24259981	1011974	0	0	0	0	0	0	0	0	0	0	0	0	24259981	0	0	23304126	21778869	18197e3	19460449	955855	20057200	0	1450937	270732	955855
SRR531871	leaf	B73	stage2_tip_V7	3	25891754	24841070	1050684	0	0	0	0	0	0	0	0	0	0	0	0	24841070	0	0	24319508	22634578	18831695	20218711	521562	20836278	0	1516516	281784	521562
SRR531872	leaf	B73	stage2_base_V7	1	21541460	20763609	777851	0	0	0	0	0	0	0	0	0	0	0	0	20763609	0	0	20280848	19323188	16279127	17076063	482761	17911256	0	1169023	242909	482761
SRR531873	leaf	B73	stage2_base_V7	2	20869984	19959997	909987	0	0	0	0	0	0	0	0	0	0	0	0	19959997	0	0	19377260	18465571	14834393	15558808	582737	17121147	0	1118120	226304	582737
SRR531874	leaf	B73	stage2_base_V7	3	14226731	13682918	543813	0	0	0	0	0	0	0	0	0	0	0	0	13682918	0	0	13354805	12719432	10270749	10777351	328113	11769180	0	794722	155530	328113
SRR531875	internode	B73	fourth_V9	1	18165394	17480781	684613	0	0	0	0	0	0	0	0	0	0	0	0	17480781	0	0	17068395	16255277	13137870	13787358	412386	15085167	0	968941	201169	412386
SRR531876	internode	B73	fourth_V9	2	18175375	17571697	603678	0	0	0	0	0	0	0	0	0	0	0	0	17571697	0	0	17234487	16408837	13260689	13920138	337210	15212832	0	997938	198067	337210
SRR531877	internode	B73	fourth_V9	3	15997388	15467354	530034	0	0	0	0	0	0	0	0	0	0	0	0	15467354	0	0	15194956	14475257	11722841	12298336	272398	13408635	0	891732	174890	272398
SRR531878	tassel	B73	immature_V13	1	29059107	28019342	1039765	0	0	0	0	0	0	0	0	0	0	0	0	28019342	0	0	27483460	26156540	21132040	22189844	535882	24155893	0	1693759	306888	535882
SRR531879	tassel	B73	immature_V13	2	20321822	19557353	764469	0	0	0	0	0	0	0	0	0	0	0	0	19557353	0	0	19062807	18132393	14607957	15346833	494546	16704267	0	1213386	214740	494546
SRR531880	tassel	B73	immature_V13	3	21830822	21022105	808717	0	0	0	0	0	0	0	0	0	0	0	0	21022105	0	0	20566970	19584643	16257767	17065035	455135	18051546	0	1298989	234108	455135
SRR531881	coleoptile	B73	6DAS_GH	6	1656666	1537322	119344	0	0	0	0	0	0	0	0	0	0	0	0	1537322	0	0	1480554	1402314	965678	1016477	56768	1302853	0	83894	15567	56768
SRR531882	tassel	B73	meiotic_V17	1	6278958	6028164	250794	0	0	0	0	0	0	0	0	0	0	0	0	6028164	0	0	5879274	5614104	4642353	4857166	148890	5123010	0	411696	79398	148890
SRR531883	tassel	B73	meiotic_V17	2	11148621	10778024	370597	0	0	0	0	0	0	0	0	0	0	0	0	10778024	0	0	10475052	9997019	8298376	8689233	302972	9101392	0	757371	138256	302972
SRR531884	tassel	B73	meiotic_V17	3	19107990	18504457	603533	0	0	0	0	0	0	0	0	0	0	0	0	18504457	0	0	18119389	17303536	14390120	15058789	385068	15769699	0	1287483	246354	385068
SRR531886	cob	B73	immature_V18	1	16323607	15844179	479428	0	0	0	0	0	0	0	0	0	0	0	0	15844179	0	0	15046241	14265555	11911715	12549495	797938	13060819	0	1046829	157907	797938
SRR531887	cob	B73	immature_V18	2	24816127	24039111	777016	0	0	0	0	0	0	0	0	0	0	0	0	24039111	0	0	23631517	22458234	18723185	19687123	407594	20611457	0	1594640	252137	407594
SRR531888	cob	B73	immature_V18	3	24761273	23877927	883346	0	0	0	0	0	0	0	0	0	0	0	0	23877927	0	0	23288122	22137694	18311140	19248352	589805	20341061	0	1539683	256950	589805
SRR531889	cob	B73	pre-pollination	1	30490451	29552489	937962	0	0	0	0	0	0	0	0	0	0	0	0	29552489	0	0	28263035	27002811	23607252	24697571	1289454	24838018	0	1824211	340582	1289454
SRR531890	cob	B73	pre-pollination	2	22156781	21525884	630897	0	0	0	0	0	0	0	0	0	0	0	0	21525884	0	0	20851066	19901459	17335906	18153334	674818	18283743	0	1370793	246923	674818
SRR531891	cob	B73	pre-pollination	3	29201131	28409670	791461	0	0	0	0	0	0	0	0	0	0	0	0	28409670	0	0	27754570	26491110	23061646	24147547	655100	24426696	0	1731668	332746	655100
SRR531892	silk	B73	R1	1	16102915	15651818	451097	0	0	0	0	0	0	0	0	0	0	0	0	15651818	0	0	15001167	14380619	12549160	13082826	650651	13230767	0	962472	187380	650651
SRR531893	silk	B73	R1	2	18160159	17672065	488094	0	0	0	0	0	0	0	0	0	0	0	0	17672065	0	0	17291153	16615532	14561063	15146826	380912	15296612	0	1105025	213895	380912
SRR531894	silk	B73	R1	3	54101718	52619313	1482405	0	0	0	0	0	0	0	0	0	0	0	0	52619313	0	0	51531602	49533989	43333270	45061114	1087711	45619979	0	3279876	634134	1087711
SRR531895	anther	B73	R1	1	13175999	12752279	423720	0	0	0	0	0	0	0	0	0	0	0	0	12752279	0	0	12433101	11619205	10041075	10726810	319178	10443949	0	1033864	141392	319178
SRR531896	anther	B73	R1	2	12930792	12323422	607370	0	0	0	0	0	0	0	0	0	0	0	0	12323422	0	0	11998811	11186249	8762724	9380121	324611	10034232	0	1019148	132869	324611
SRR531897	anther	B73	R1	3	27987824	26729579	1258245	0	0	0	0	0	0	0	0	0	0	0	0	26729579	0	0	25781531	24069754	18869546	20172764	948048	21605392	0	2177632	286730	948048
SRR531898	seed	B73	2DAP	1	13276194	12753511	522683	0	0	0	0	0	0	0	0	0	0	0	0	12753511	0	0	12137778	11551374	9099422	9551685	615733	10615201	0	782995	153178	615733
SRR531899	seed	B73	2DAP	2	21908199	21197138	711061	0	0	0	0	0	0	0	0	0	0	0	0	21197138	0	0	20813758	19853701	15719070	16465660	383380	18278354	0	1318598	256749	383380
SRR531900	seed	B73	2DAP	3	19432038	18516270	915768	0	0	0	0	0	0	0	0	0	0	0	0	18516270	0	0	18248253	17454069	13558671	14167854	268017	16103850	0	1107396	242823	268017
SRR531901	seed	B73	4DAP	1	21178997	20441342	737655	0	0	0	0	0	0	0	0	0	0	0	0	20441342	0	0	19828405	18925579	15017692	15719139	612937	17392542	0	1287616	245421	612937
SRR531902	seed	B73	4DAP	2	68029636	65382991	2646645	0	0	0	0	0	0	0	0	0	0	0	0	65382991	0	0	63828928	60956322	48027574	50250803	1554063	56132840	0	4030545	792937	1554063
SRR531903	seed	B73	4DAP	3	19322241	18082859	1239382	0	0	0	0	0	0	0	0	0	0	0	0	18082859	0	0	17711529	16911575	12033303	12591291	371330	15507205	0	1184180	220190	371330
SRR531904	seed	B73	6DAP	1	15758780	14867778	891002	0	0	0	0	0	0	0	0	0	0	0	0	14867778	0	0	14528040	13835273	9922492	10407196	339738	12653790	0	992025	189458	339738
SRR531905	seed	B73	6DAP	2	23055017	21716585	1338432	0	0	0	0	0	0	0	0	0	0	0	0	21716585	0	0	21086037	20120300	14319677	14992525	630548	18480287	0	1364018	275995	630548
SRR531906	seed	B73	6DAP	3	21061509	19567526	1493983	0	0	0	0	0	0	0	0	0	0	0	0	19567526	0	0	19095181	18220684	13077866	13693055	472345	16731118	0	1238923	250643	472345
SRR531907	seed	B73	8DAP	1	26050179	24616466	1433713	0	0	0	0	0	0	0	0	0	0	0	0	24616466	0	0	23944576	22852466	16465780	17235456	671890	21045764	0	1500091	306611	671890
SRR531908	seed	B73	8DAP	2	16732757	15748532	984225	0	0	0	0	0	0	0	0	0	0	0	0	15748532	0	0	13940417	13211181	9404097	9897142	1808115	12118878	0	907358	184945	1808115
SRR531909	seed	B73	8DAP	3	21896715	20728531	1168184	0	0	0	0	0	0	0	0	0	0	0	0	20728531	0	0	20311945	19380074	13926386	14582304	416586	17813802	0	1305939	260333	416586
SRR531910	seed	B73	18DAP	1	18692953	17613241	1079712	0	0	0	0	0	0	0	0	0	0	0	0	17613241	0	0	17200979	15937948	11186163	12057775	412262	14445125	0	1234820	258003	412262
SRR531911	seed	B73	18DAP	2	7227940	6860879	367061	0	0	0	0	0	0	0	0	0	0	0	0	6860879	0	0	6599951	6093454	4309583	4660629	260928	5490863	0	501828	100763	260928
SRR531912	seed	B73	18DAP	3	17261204	16072067	1189137	0	0	0	0	0	0	0	0	0	0	0	0	16072067	0	0	15725829	14569416	10061186	10853243	346238	13217143	0	1115428	236845	346238
SRR531913	endosperm	B73	18DAP	1	33886845	32252443	1634402	0	0	0	0	0	0	0	0	0	0	0	0	32252443	0	0	31043076	28454487	20263711	22054990	1209367	25575910	0	2368688	509889	1209367
SRR531914	endosperm	B73	18DAP	2	31753606	30242868	1510738	0	0	0	0	0	0	0	0	0	0	0	0	30242868	0	0	29508232	26873960	19048939	20875159	734636	23973152	0	2388427	512381	734636
SRR531915	endosperm	B73	18DAP	3	13540687	12635744	904943	0	0	0	0	0	0	0	0	0	0	0	0	12635744	0	0	12359617	11343528	7874794	8574821	276127	10195355	0	943233	204940	276127
SRR531916	embryo	B73	18DAP	1	20885092	19577703	1307389	0	0	0	0	0	0	0	0	0	0	0	0	19577703	0	0	19036370	18132028	12628884	13246845	541333	16850312	0	1072886	208830	541333
SRR531917	embryo	B73	18DAP	2	36987657	35053221	1934436	0	0	0	0	0	0	0	0	0	0	0	0	35053221	0	0	32839788	31082327	22125597	23339554	2213433	28922195	0	1811851	348281	2213433
SRR531919	embryo	B73	18DAP	3	15062608	14367603	695005	0	0	0	0	0	0	0	0	0	0	0	0	14367603	0	0	13451012	12740129	9121839	9616230	916591	11853177	0	741342	145610	916591
SRR531920	seed	B73	pericarp_18DAP	2	25206148	24011076	1195072	0	0	0	0	0	0	0	0	0	0	0	0	24011076	0	0	22697972	21655440	15456866	16182600	1313104	19761365	0	1607903	286172	1313104
SRR531921	seed	B73	pericarp_18DAP	3	24082750	22369040	1713710	0	0	0	0	0	0	0	0	0	0	0	0	22369040	0	0	21464595	20540645	14809713	15458700	904445	18823727	0	1455400	261518	904445
SRR531922	seed	B73	20DAP	1	26845118	25386330	1458788	0	0	0	0	0	0	0	0	0	0	0	0	25386330	0	0	24621380	22377720	16160992	17756531	764950	19663110	0	2255316	459294	764950
SRR531924	seed	B73	20DAP	2	33960111	32263015	1697096	0	0	0	0	0	0	0	0	0	0	0	0	32263015	0	0	25214304	22047713	15826134	18010909	7048711	18713291	0	2765346	569076	7048711
SRR531925	seed	B73	20DAP	3	22540383	21642010	898373	0	0	0	0	0	0	0	0	0	0	0	0	21642010	0	0	20453952	18434572	13315872	14743157	1188058	16080957	0	1964760	388855	1188058
SRR531926	endosperm	B73	20DAP	1	28857741	27279286	1578455	0	0	0	0	0	0	0	0	0	0	0	0	27279286	0	0	22339437	19709761	13467617	15203283	4939849	16865541	0	2399896	444324	4939849
SRR531928	endosperm	B73	20DAP	2	20658488	19539811	1118677	0	0	0	0	0	0	0	0	0	0	0	0	19539811	0	0	16198690	14246317	9703962	10991364	3341121	12150851	0	1755411	340055	3341121
SRR531929	endosperm	B73	20DAP	3	30345595	28956986	1388609	0	0	0	0	0	0	0	0	0	0	0	0	28956986	0	0	27596598	24599708	16838796	18845301	1360388	21141881	0	2873515	584312	1360388
SRR531930	embryo	B73	20DAP	1	16618608	15770098	848510	0	0	0	0	0	0	0	0	0	0	0	0	15770098	0	0	15282445	14503650	9846342	10364164	487653	13462820	0	874266	166564	487653
SRR531931	embryo	B73	20DAP	2	15462088	14793546	668542	0	0	0	0	0	0	0	0	0	0	0	0	14793546	0	0	14315075	13579742	9337380	9832664	478471	12629227	0	802632	147883	478471
SRR531932	embryo	B73	20DAP	3	18858119	18041604	816515	0	0	0	0	0	0	0	0	0	0	0	0	18041604	0	0	17449310	16554091	11393734	11996925	592294	15388348	0	990807	174936	592294
SRR531933	seed	B73	22DAP	1	22716882	21645011	1071871	0	0	0	0	0	0	0	0	0	0	0	0	21645011	0	0	20871745	18813524	12867054	14251264	773266	16346592	0	2035623	431309	773266
SRR531934	seed	B73	22DAP	2	30303646	28800188	1503458	0	0	0	0	0	0	0	0	0	0	0	0	28800188	0	0	27171948	24546132	16825121	18581894	1628240	21418834	0	2605987	521311	1628240
SRR531935	seed	B73	22DAP	3	25504362	24372420	1131942	0	0	0	0	0	0	0	0	0	0	0	0	24372420	0	0	23476972	21133932	13203879	14633440	895448	18365405	0	2274235	494292	895448
SRR531936	endosperm	B73	22DAP	1	17230911	16429896	801015	0	0	0	0	0	0	0	0	0	0	0	0	16429896	0	0	15647935	13998797	8767199	9779871	781961	11968449	0	1668304	362044	781961
SRR531937	endosperm	B73	22DAP	2	16211696	15474927	736769	0	0	0	0	0	0	0	0	0	0	0	0	15474927	0	0	14875341	13245409	8249981	9247718	599586	11283205	0	1635172	327032	599586
SRR531938	endosperm	B73	22DAP	3	22004829	21144299	860530	0	0	0	0	0	0	0	0	0	0	0	0	21144299	0	0	20586643	18183246	11420709	12896300	557656	15322478	0	2391507	469261	557656
SRR531939	embryo	B73	22DAP	1	11961956	11504116	457840	0	0	0	0	0	0	0	0	0	0	0	0	11504116	0	0	11217873	10641317	6695880	7049456	286243	9832381	0	685277	123659	286243
SRR531940	embryo	B73	22DAP	2	20538215	19661099	877116	0	0	0	0	0	0	0	0	0	0	0	0	19661099	0	0	19050198	18067056	11298335	11899131	610901	16711971	0	1146634	208451	610901
SRR531941	embryo	B73	22DAP	3	27124111	25955947	1168164	0	0	0	0	0	0	0	0	0	0	0	0	25955947	0	0	25320690	24059708	15008801	15779648	635257	22298107	0	1496666	264935	635257
SRR531942	seed	B73	24DAP	1	38769265	36900401	1868864	0	0	0	0	0	0	0	0	0	0	0	0	36900401	0	0	35741109	32267048	20139136	22265291	1159292	28057509	0	3463325	746214	1159292
SRR531944	seed	B73	24DAP	2	34994687	33662166	1332521	0	0	0	0	0	0	0	0	0	0	0	0	33662166	0	0	32862191	29444598	22522786	25099584	799975	25392738	0	3371805	680055	799975
SRR531945	seed	B73	24DAP	3	26008958	24960739	1048219	0	0	0	0	0	0	0	0	0	0	0	0	24960739	0	0	24187997	21781855	16589142	18391508	772742	18845917	0	2401093	534845	772742
SRR531946	endosperm	B73	24DAP	1	16703204	16048170	655034	0	0	0	0	0	0	0	0	0	0	0	0	16048170	0	0	15588765	13893888	10596233	11873448	459405	11785561	0	1758430	349897	459405
SRR533828	endosperm	B73	24DAP	2	17552684	16880342	672342	0	0	0	0	0	0	0	0	0	0	0	0	16880342	0	0	16487570	14626144	11108972	12505045	392772	12346688	0	1906641	372815	392772
SRR533829	endosperm	B73	24DAP	3	13155429	12605581	549848	0	0	0	0	0	0	0	0	0	0	0	0	12605581	0	0	12296940	10952270	8324375	9338468	308641	9325611	0	1371848	254811	308641
SRR533835	embryo	B73	24DAP	1	24288855	23238561	1050294	0	0	0	0	0	0	0	0	0	0	0	0	23238561	0	0	22684658	21558943	16371423	17213786	553903	19780416	0	1497851	280676	553903
SRR533845	embryo	B73	24DAP	2	23044793	22059219	985574	0	0	0	0	0	0	0	0	0	0	0	0	22059219	0	0	21628192	20537581	15610347	16429069	431027	18858968	0	1414651	263962	431027
SRR533848	embryo	B73	24DAP	3	28053936	26890902	1163034	0	0	0	0	0	0	0	0	0	0	0	0	26890902	0	0	25651033	24357534	18643922	19618508	1239869	22409010	0	1619664	328860	1239869
SRR940236	leaf	B73	pooled_V1	7	18462494	15978543	2483951	0	0	0	0	0	0	0	0	0	0	0	0	15978543	0	0	15412229	14227979	8591521	9272303	566314	13200983	0	851731	175265	566314
SRR940237	leaf	B73	8_V9	4	21370924	16185536	5185388	0	0	0	0	0	0	0	0	0	0	0	0	16185536	0	0	15524603	14753805	7773946	8167787	660933	13695286	0	871760	186759	660933
SRR940238	leaf	B73	8_V9	5	7573491	6038143	1535348	0	0	0	0	0	0	0	0	0	0	0	0	6038143	0	0	5740762	5332172	2927961	3142251	297381	4909889	0	355128	67155	297381
SRR940239	leaf	B73	8_V9	6	5337862	4233566	1104296	0	0	0	0	0	0	0	0	0	0	0	0	4233566	0	0	4074884	3835055	2078124	2203490	158682	3544476	0	243437	47142	158682
SRR940249	leaf	B73	11_V9	4	8700245	7451376	1248869	0	0	0	0	0	0	0	0	0	0	0	0	7451376	0	0	7225989	6881572	4225739	4433804	225387	6380019	0	416387	85166	225387
SRR940250	leaf	B73	11_V9	5	7939105	6789487	1149618	0	0	0	0	0	0	0	0	0	0	0	0	6789487	0	0	6558413	6219158	3809844	4014848	231074	5769222	0	375042	74894	231074
SRR940251	leaf	B73	11_V9	6	3201328	2737256	464072	0	0	0	0	0	0	0	0	0	0	0	0	2737256	0	0	2600534	2457209	1502740	1587243	136722	2285938	0	141080	30191	136722
SRR940252	leaf	B73	13_V9	4	12363437	9949124	2414313	0	0	0	0	0	0	0	0	0	0	0	0	9949124	0	0	9451995	8968986	5058095	5327602	497129	8276026	0	580386	112574	497129
SRR940253	leaf	B73	13_V9	5	9592796	7618133	1974663	0	0	0	0	0	0	0	0	0	0	0	0	7618133	0	0	7152048	6801040	3807808	4001885	466085	6285095	0	429113	86832	466085
SRR940254	leaf	B73	13_V9	6	8498692	6772167	1726525	0	0	0	0	0	0	0	0	0	0	0	0	6772167	0	0	6354229	6056306	3385173	3550312	417938	5591057	0	387151	78098	417938
SRR940255	leaf	B73	immature_V9	4	13253623	10219220	3034403	0	0	0	0	0	0	0	0	0	0	0	0	10219220	0	0	9532994	9139949	4743518	4946909	686226	8403080	0	590986	145883	686226
SRR940256	leaf	B73	immature_V9	5	17563036	13732197	3830839	0	0	0	0	0	0	0	0	0	0	0	0	13732197	0	0	12811220	12298028	6411294	6677413	920977	11300148	0	802173	195707	920977
SRR940257	leaf	B73	immature_V9	6	12330906	9758092	2572814	0	0	0	0	0	0	0	0	0	0	0	0	9758092	0	0	9207327	8824204	4669552	4871356	550765	8097395	0	593296	133513	550765
SRR940258	tassel	B73	meiotic_V17	4	57555277	55979864	1575413	0	0	0	0	0	0	0	0	0	0	0	0	55979864	0	0	54195254	51791906	41828369	43733123	1784610	47320768	0	3726926	744212	1784610
SRR940259	leaf	B73	13_VT	4	6217809	5042398	1175411	0	0	0	0	0	0	0	0	0	0	0	0	5042398	0	0	4505788	4110621	2241547	2444462	536610	3749066	0	309347	52208	536610
SRR940260	leaf	B73	13_VT	5	7610859	6032554	1578305	0	0	0	0	0	0	0	0	0	0	0	0	6032554	0	0	5638955	5348392	2831942	2983236	393599	4952679	0	330996	64717	393599
SRR940274	leaf	B73	13_VT	6	9939688	7970884	1968804	0	0	0	0	0	0	0	0	0	0	0	0	7970884	0	0	7327704	6684798	3612765	3941585	643180	6139304	0	459665	85829	643180
SRR940276	leaf	B73	13_R2	4	10640131	9026563	1613568	0	0	0	0	0	0	0	0	0	0	0	0	9026563	0	0	8495486	8066442	4890259	5145606	531077	7500918	0	463728	101796	531077
SRR940278	leaf	B73	13_R2	5	13097581	10893720	2203861	0	0	0	0	0	0	0	0	0	0	0	0	10893720	0	0	10252671	9756531	5843711	6135319	641049	9074550	0	558416	123565	641049
SRR940279	leaf	B73	13_R2	6	3339042	2780380	558662	0	0	0	0	0	0	0	0	0	0	0	0	2780380	0	0	2598868	2478133	1466377	1536785	181512	2323807	0	123433	30893	181512
SRR940280	seed	B73	10DAP	4	18431351	17053797	1377554	0	0	0	0	0	0	0	0	0	0	0	0	17053797	0	0	16848842	16100678	10823413	11320391	204955	14932248	0	959795	208635	204955
SRR940281	seed	B73	10DAP	5	17147567	15860445	1287122	0	0	0	0	0	0	0	0	0	0	0	0	15860445	0	0	15593430	14893289	9915366	10375504	267015	13795356	0	905944	191989	267015
SRR940283	seed	B73	12DAP	4	14903814	13810924	1092890	0	0	0	0	0	0	0	0	0	0	0	0	13810924	0	0	13488927	12838101	8684269	9115696	321997	12019957	0	670437	147707	321997
SRR940284	seed	B73	12DAP	5	9833536	9106601	726935	0	0	0	0	0	0	0	0	0	0	0	0	9106601	0	0	8937670	8501396	5738460	6027313	168931	7939869	0	461250	100277	168931
SRR940286	seed	B73	12DAP	6	17054658	15838821	1215837	0	0	0	0	0	0	0	0	0	0	0	0	15838821	0	0	15437609	14658653	9886155	10399854	401212	13663844	0	822111	172698	401212
SRR940287	endosperm	B73	12DAP	4	68501530	67544088	957442	0	0	0	0	0	0	0	0	0	0	0	0	67544088	0	0	64894639	61599804	46454481	48894245	2649449	58106923	0	2853791	639090	2649449
SRR940289	endosperm	B73	12DAP	5	57163500	55598052	1565448	0	0	0	0	0	0	0	0	0	0	0	0	55598052	0	0	53652123	50883284	40984040	43174138	1945929	47927141	0	2425060	531083	1945929
SRR940290	seed	B73	14DAP	4	19003558	17143806	1859752	0	0	0	0	0	0	0	0	0	0	0	0	17143806	0	0	16846898	15990729	9964727	10485608	296908	14976967	0	832692	181070	296908
SRR940291	seed	B73	14DAP	5	13637259	12294401	1342858	0	0	0	0	0	0	0	0	0	0	0	0	12294401	0	0	12078152	11414077	7159921	7568480	216249	10639466	0	642302	132309	216249
SRR940292	endosperm	B73	14DAP	4	15313763	14273466	1040297	0	0	0	0	0	0	0	0	0	0	0	0	14273466	0	0	14063624	13253124	8976715	9515733	209842	12427298	0	678326	147500	209842
SRR940293	seed	B73	16DAP	4	11266865	10451329	815536	0	0	0	0	0	0	0	0	0	0	0	0	10451329	0	0	9802814	9169810	6239052	6655983	648515	8437682	0	607555	124573	648515
SRR940294	endosperm	B73	16DAP	4	11259554	9151011	2108543	0	0	0	0	0	0	0	0	0	0	0	0	9151011	0	0	8785745	8245185	4443706	4737849	365266	7574871	0	557379	112935	365266
SRR940295	endosperm	B73	16DAP	5	11789391	9454428	2334963	0	0	0	0	0	0	0	0	0	0	0	0	9454428	0	0	8854148	8293799	4489126	4790422	600280	7617787	0	558884	117128	600280
SRR940296	endosperm	B73	16DAP	6	17492050	14283509	3208541	0	0	0	0	0	0	0	0	0	0	0	0	14283509	0	0	13575026	12865608	6967593	7349962	708483	11992998	0	720655	151955	708483
SRR940297	embryo	B73	16DAP	4	14364117	11469840	2894277	0	0	0	0	0	0	0	0	0	0	0	0	11469840	0	0	10882346	10435204	5600976	5839547	587494	9707060	0	591207	136937	587494
SRR940298	embryo	B73	16DAP	5	10425002	8310519	2114483	0	0	0	0	0	0	0	0	0	0	0	0	8310519	0	0	7958740	7626349	4088710	4268483	351779	7093067	0	428080	105202	351779
SRR940299	embryo	B73	16DAP	6	15314143	12120176	3193967	0	0	0	0	0	0	0	0	0	0	0	0	12120176	0	0	11272548	10788824	5757377	6011251	847628	10018058	0	629584	141182	847628
SRR940300	seed	B73	18DAP	4	16883589	15797620	1085969	0	0	0	0	0	0	0	0	0	0	0	0	15797620	0	0	15334606	14173764	9667545	10448631	463014	12789779	0	1150597	233388	463014
