SampleID	Tissue	Genotype	Treatment	Replicate	total	passed	failed	pair	pair_bad	pair_dup	pair_map	pair_map_hq	pair_map_hq0	pair_map0	pair_orphan	pair_orphan_hq	pair_orphan_hq0	pair_orphan0	pair_unmap	unpair	unpair_bad	unpair_dup	unpair_map	unpair_map_hq	unpair_map_hq0	unpair_map0	unpair_unmap	Assigned	Unassigned_MultiMapping	Unassigned_NoFeatures	Unassigned_Ambiguity	Unassigned_Unmapped
SRR651049	unknown	B73	NA	1	13399149	12903659	495490	12903659	0	0	12464252	11641387	7401780	7914949	0	0	0	0	439407	0	0	0	0	0	0	0	0	11061883	2638487	470375	109129	439407
SRR651050	unknown	B73	NA	2	14152930	13629346	523584	13629346	0	0	13325623	12581330	8012928	8479013	0	0	0	0	303723	0	0	0	0	0	0	0	0	11974913	2113765	488879	117538	303723
SRR651051	unknown	B73	NA	3	19270220	18559087	711133	18559087	0	0	16439481	15271162	9633683	10351482	0	0	0	0	2119606	0	0	0	0	0	0	0	0	14447590	4003867	682336	141236	2119606
SRR651052	unknown	B97	NA	1	13884840	13353808	531032	13353808	0	0	12623889	11695358	5485480	5956038	0	0	0	0	729919	0	0	0	0	0	0	0	0	11116420	2717600	473098	105840	729919
SRR651053	unknown	CML103	NA	1	17172512	16370536	801976	16370536	0	0	15459692	14519765	8205616	8807032	0	0	0	0	910844	0	0	0	0	0	0	0	0	13841270	2779606	538327	140168	910844
SRR651054	unknown	CML228	NA	1	13453936	12972882	481054	12972882	0	0	12193594	11362858	5052156	5475880	0	0	0	0	779288	0	0	0	0	0	0	0	0	10774438	2445231	474791	113629	779288
SRR651055	unknown	CML247	NA	1	14714190	14008543	705647	14008543	0	0	12355394	11510941	6453018	6972133	0	0	0	0	1653149	0	0	0	0	0	0	0	0	10925204	2513415	464280	121457	1653149
SRR651056	unknown	CML277	NA	1	16421326	15654695	766631	15654695	0	0	14725218	13726752	7741099	8290511	0	0	0	0	929477	0	0	0	0	0	0	0	0	12969249	2916176	622459	135044	929477
SRR651057	unknown	CML322	NA	1	12775245	12310704	464541	12310704	0	0	11613002	10881535	4845136	5197144	0	0	0	0	697702	0	0	0	0	0	0	0	0	10352046	2041526	424372	105117	697702
SRR651058	unknown	CML333	NA	1	16630744	15823784	806960	15823784	0	0	14432622	13398171	7556867	8218889	0	0	0	0	1391162	0	0	0	0	0	0	0	0	12773931	3091651	484926	139314	1391162
SRR651059	unknown	CML52	NA	1	16817165	16204919	612246	16204919	0	0	15280419	14253886	6317968	6814481	0	0	0	0	924500	0	0	0	0	0	0	0	0	13579838	2960835	534972	139076	924500
SRR651060	unknown	Hp301	NA	1	16861363	16247629	613734	16247629	0	0	15423087	14448341	6557429	7042263	0	0	0	0	824542	0	0	0	0	0	0	0	0	13675917	2734640	632956	139468	824542
SRR651061	unknown	Il14h	NA	1	12653042	12178400	474642	12178400	0	0	11329628	10463895	4770319	5152064	0	0	0	0	848772	0	0	0	0	0	0	0	0	9924322	2672522	437101	102472	848772
SRR651062	unknown	Ki11	NA	1	15273635	14705396	568239	14705396	0	0	13103420	12188800	5389222	5857285	0	0	0	0	1601976	0	0	0	0	0	0	0	0	11613541	2661373	456959	118300	1601976
SRR651063	unknown	Ki11	NA	2	11271601	10859576	412025	10859576	0	0	10118299	9421235	4172688	4526897	0	0	0	0	741277	0	0	0	0	0	0	0	0	8913749	2071441	413014	94472	741277
SRR651064	unknown	Ki11	NA	3	12018859	11583016	435843	11583016	0	0	10467394	9744139	4318463	4686562	0	0	0	0	1115622	0	0	0	0	0	0	0	0	9241219	2148371	407396	95524	1115622
SRR651065	unknown	Ki3	NA	1	14579133	13873437	705696	13873437	0	0	11469622	10743906	6106435	6554445	0	0	0	0	2403815	0	0	0	0	0	0	0	0	10198500	2314003	447073	98333	2403815
SRR651066	unknown	M162w	NA	1	16162782	15027971	1134811	15027971	0	0	14175031	13266453	7063250	7583637	0	0	0	0	852940	0	0	0	0	0	0	0	0	12583798	2591208	548012	134643	852940
SRR651067	unknown	M37w	NA	1	17770712	16520354	1250358	16520354	0	0	15223150	14125848	7382742	8006300	0	0	0	0	1297204	0	0	0	0	0	0	0	0	13382708	3622054	604186	138954	1297204
SRR651068	unknown	M37w	NA	2	16078002	15323733	754269	15323733	0	0	13949374	12801107	7387945	8129614	0	0	0	0	1374359	0	0	0	0	0	0	0	0	12195417	3945359	480331	125359	1374359
SRR651069	unknown	Mo17	NA	1	15801487	14714978	1086509	14714978	0	0	13105002	12289442	6512431	6945148	0	0	0	0	1609976	0	0	0	0	0	0	0	0	11671886	2385160	490598	126958	1609976
SRR651070	unknown	Mo17	NA	2	17745280	16492099	1253181	16492099	0	0	15569135	14603025	7786272	8297611	0	0	0	0	922964	0	0	0	0	0	0	0	0	13904152	2763965	547151	151722	922964
SRR651071	unknown	Mo17	NA	3	14336816	13333402	1003414	13333402	0	0	12583287	11816420	6285507	6686519	0	0	0	0	750115	0	0	0	0	0	0	0	0	11251024	2163366	442631	122765	750115
SRR651072	unknown	Mo18w	NA	1	10285877	9571298	714579	9571298	0	0	9033993	8530035	4360835	4641014	0	0	0	0	537305	0	0	0	0	0	0	0	0	8145405	1410643	301883	82747	537305
SRR651073	unknown	MS71	NA	1	22338440	20823501	1514939	20823501	0	0	19643190	18442700	9801165	10458962	0	0	0	0	1180311	0	0	0	0	0	0	0	0	17414537	3432341	858333	169830	1180311
SRR651074	unknown	MS71	NA	2	14688550	13674575	1013975	13674575	0	0	12832440	12105518	6430715	6826689	0	0	0	0	842135	0	0	0	0	0	0	0	0	11493200	2023174	498849	113469	842135
SRR651075	unknown	MS71	NA	3	13968336	13015331	953005	13015331	0	0	12304666	11606696	6176713	6554048	0	0	0	0	710665	0	0	0	0	0	0	0	0	11006265	1907016	493039	107392	710665
SRR651076	unknown	NC358	NA	1	13260113	12349452	910661	12349452	0	0	11572192	10883422	5562145	5928550	0	0	0	0	777260	0	0	0	0	0	0	0	0	10345048	2061610	432035	106339	777260
SRR651077	unknown	Oh43	NA	1	11766590	10954680	811910	10954680	0	0	10230040	9592728	5199041	5531279	0	0	0	0	724640	0	0	0	0	0	0	0	0	9129550	1900277	373964	89214	724640
SRR651078	unknown	Oh43	NA	2	14922276	13914466	1007810	13914466	0	0	12974540	12201332	6631234	7031122	0	0	0	0	939926	0	0	0	0	0	0	0	0	11582039	2278556	502775	116518	939926
SRR651079	unknown	Oh43	NA	3	18200539	17346491	854048	17346491	0	0	16424932	15330473	9130228	9758658	0	0	0	0	921559	0	0	0	0	0	0	0	0	14638496	3141773	544277	147700	921559
SRR651080	unknown	Oh7b	NA	1	22855866	21817877	1037989	21817877	0	0	20704434	19465321	11537014	12228808	0	0	0	0	1113443	0	0	0	0	0	0	0	0	18461254	3490849	814910	189157	1113443
SRR651081	unknown	P39	NA	1	21748449	20747524	1000925	20747524	0	0	18465114	17257179	9620091	10259331	0	0	0	0	2282410	0	0	0	0	0	0	0	0	16380492	3394110	710610	166077	2282410
SRR651082	unknown	Tx303	NA	1	17474393	16602884	871509	16602884	0	0	15532839	14437760	8357239	8993763	0	0	0	0	1070045	0	0	0	0	0	0	0	0	13756570	3255905	536977	144213	1070045
SRR651083	unknown	Tzi8	NA	1	16202133	15436531	765602	15436531	0	0	14548743	13602304	7699814	8316004	0	0	0	0	887788	0	0	0	0	0	0	0	0	12944979	2735114	521900	135425	887788
SRR651084	unknown	W22	NA	1	11254201	10710943	543258	10710943	0	0	10000710	9254719	5335548	5824682	0	0	0	0	710233	0	0	0	0	0	0	0	0	8772413	2262219	386886	95420	710233
SRR766776	unknown	B97	NA	2	24503625	23720488	783137	23720488	0	0	22315306	20572287	12766371	13964156	0	0	0	0	1405182	0	0	0	0	0	0	0	0	19558594	5236271	824484	189209	1405182
SRR766777	unknown	B97	NA	3	25796328	24937640	858688	24937640	0	0	23780927	22150399	13725219	14811538	0	0	0	0	1156713	0	0	0	0	0	0	0	0	21072533	4438889	878451	199415	1156713
SRR767675	unknown	CML103	NA	2	20322950	19702973	619977	19702973	0	0	18623270	17427395	10474801	11299682	0	0	0	0	1079703	0	0	0	0	0	0	0	0	16593690	3531725	670757	162948	1079703
SRR767678	unknown	Hp301	NA	2	23492306	22772858	719448	22772858	0	0	21594128	20151380	12167837	13139439	0	0	0	0	1178730	0	0	0	0	0	0	0	0	19066212	4291621	897606	187562	1178730
SRR767679	unknown	Hp301	NA	3	25001232	24248132	753100	24248132	0	0	23081314	21723317	13076989	13972344	0	0	0	0	1166818	0	0	0	0	0	0	0	0	20627280	3733694	889418	206619	1166818
SRR767680	unknown	Ky21	NA	1	26260623	25432363	828260	25432363	0	0	23980373	22318801	13603422	14684924	0	0	0	0	1451990	0	0	0	0	0	0	0	0	21220563	5001845	879751	218487	1451990
SRR767682	unknown	M37w	NA	3	26066928	25251303	815625	25251303	0	0	23889296	22163437	13282798	14404089	0	0	0	0	1362007	0	0	0	0	0	0	0	0	21076990	5086276	865651	220796	1362007
SRR767683	unknown	MR01	NA	1	33293971	32245418	1048553	32245418	0	0	30473632	28691091	16384282	17419384	0	0	0	0	1771786	0	0	0	0	0	0	0	0	26997453	5462431	1388175	305463	1771786
SRR767684	unknown	MR02	NA	1	22701337	22014021	687316	22014021	0	0	20794886	19414353	11237982	11985765	0	0	0	0	1219135	0	0	0	0	0	0	0	0	18423371	3785072	794890	196092	1219135
SRR767685	unknown	MR10	NA	1	30073450	29057071	1016379	29057071	0	0	27485930	25692178	14837401	15789765	0	0	0	0	1571141	0	0	0	0	0	0	0	0	24379107	5131328	1069741	243330	1571141
SRR767686	unknown	MR18	NA	1	31043442	30075879	967563	30075879	0	0	28425849	26708832	15136903	16184770	0	0	0	0	1650030	0	0	0	0	0	0	0	0	25120223	4903193	1318085	270524	1650030
SRR767687	unknown	MR20	NA	1	32141650	31091998	1049652	31091998	0	0	29537593	27601241	16524908	17815843	0	0	0	0	1554405	0	0	0	0	0	0	0	0	25991584	5449068	1356186	253471	1554405
SRR767688	unknown	MR22	NA	1	30555562	29574579	980983	29574579	0	0	28120462	26396740	15519452	16621684	0	0	0	0	1454117	0	0	0	0	0	0	0	0	24931801	4759108	1196007	268932	1454117
SRR767689	unknown	MR25	NA	1	31394449	30346988	1047461	30346988	0	0	28801586	27054595	15684407	16747712	0	0	0	0	1545402	0	0	0	0	0	0	0	0	25414886	4775133	1385856	253853	1545402
SRR767690	unknown	Oh7b	NA	2	26354947	25519304	835643	25519304	0	0	23985693	22497088	13860138	14714992	0	0	0	0	1533611	0	0	0	0	0	0	0	0	21377190	4335233	898643	221255	1533611
SRR767691	unknown	Oh7b	NA	3	27042424	26182451	859973	26182451	0	0	24864867	23386251	14479993	15309747	0	0	0	0	1317584	0	0	0	0	0	0	0	0	22251751	4084805	912806	221694	1317584
SRR767692	unknown	TIL01	NA	1	32746e3	31607047	1138953	31607047	0	0	29742585	27769367	13718917	14820053	0	0	0	0	1864462	0	0	0	0	0	0	0	0	26448137	5123845	1020910	300320	1864462
SRR767693	unknown	TIL06	NA	1	33196714	32119192	1077522	32119192	0	0	29962464	28079702	13950136	14978067	0	0	0	0	2156728	0	0	0	0	0	0	0	0	26660017	5392895	1130302	289383	2156728
SRR767694	unknown	TIL07	NA	1	30048309	29063295	985014	29063295	0	0	27241058	25467035	12829912	13846645	0	0	0	0	1822237	0	0	0	0	0	0	0	0	24268973	5142476	931459	266603	1822237
SRR767695	unknown	TIL09	NA	1	34970995	33862428	1108567	33862428	0	0	31700470	29506788	14714082	15924048	0	0	0	0	2161958	0	0	0	0	0	0	0	0	27848383	6520943	1352546	305859	2161958
SRR767696	unknown	TIL11	NA	1	22214335	21551740	662595	21551740	0	0	20275965	19022215	9721096	10338854	0	0	0	0	1275775	0	0	0	0	0	0	0	0	18106796	3459531	733825	181594	1275775
SRR767697	unknown	TIL14	NA	1	21011623	20372626	638997	20372626	0	0	19181908	17759507	8830788	9515559	0	0	0	0	1190718	0	0	0	0	0	0	0	0	16910519	3934511	665101	183887	1190718
SRR767698	unknown	TIL15	NA	1	21884742	21254869	629873	21254869	0	0	20006249	19030354	9402935	9921880	0	0	0	0	1248620	0	0	0	0	0	0	0	0	18145098	2666025	707077	178179	1248620
SRR767699	unknown	TIL16	NA	1	24542055	23860734	681321	23860734	0	0	22379669	21070413	10044461	10661867	0	0	0	0	1481065	0	0	0	0	0	0	0	0	19994619	3421725	871873	203921	1481065
SRR767700	unknown	TIL17	NA	1	20940234	20251209	689025	20251209	0	0	19156958	17860827	9478295	10248717	0	0	0	0	1094251	0	0	0	0	0	0	0	0	17155712	3402628	542528	162587	1094251
SRR767701	unknown	Tx303	NA	2	26313196	25466320	846876	25466320	0	0	24261805	22711070	13689895	14550706	0	0	0	0	1204515	0	0	0	0	0	0	0	0	21573117	4197830	918287	219666	1204515
SRR767702	unknown	Tx303	NA	3	25230109	24414746	815363	24414746	0	0	23201358	21729663	13019224	13825675	0	0	0	0	1213388	0	0	0	0	0	0	0	0	20697776	3928468	817608	214279	1213388
SRR767703	unknown	W64A	NA	1	22014734	21330362	684372	21330362	0	0	20258679	19041862	11679871	12482892	0	0	0	0	1071683	0	0	0	0	0	0	0	0	18082617	3482399	773724	185521	1071683
SRR767705	unknown	MR19	NA	1	29427624	28448760	978864	28448760	0	0	26624894	24450576	13767254	15149320	0	0	0	0	1823866	0	0	0	0	0	0	0	0	23072435	6529075	1146368	231773	1823866
SRR767708	unknown	MR14	NA	1	21719977	21054207	665770	21054207	0	0	19908700	18499905	10830298	11577077	0	0	0	0	1145507	0	0	0	0	0	0	0	0	17556524	3908452	758839	184542	1145507
SRR767709	unknown	MR09	NA	1	40668557	39459025	1209532	39459025	0	0	36036455	33175436	18737481	20635169	0	0	0	0	3422570	0	0	0	0	0	0	0	0	30681655	9146872	2138782	354999	3422570
SRR767712	unknown	CML333	NA	2	26377363	25524714	852649	25524714	0	0	24172506	22623034	13288923	14300659	0	0	0	0	1352208	0	0	0	0	0	0	0	0	21582716	4112708	814834	225484	1352208
SRR767716	unknown	CML322	NA	2	23053240	22345039	708201	22345039	0	0	21064711	19694690	11634228	12527369	0	0	0	0	1280328	0	0	0	0	0	0	0	0	18779673	3788823	721882	193135	1280328
SRR767717	unknown	CML322	NA	3	19471126	18869977	601149	18869977	0	0	17842217	16669340	9878278	10648321	0	0	0	0	1027760	0	0	0	0	0	0	0	0	15923292	3190237	585566	160482	1027760
SRR767718	unknown	CML333	NA	3	22182621	21500791	681830	21500791	0	0	20334223	19073960	11317515	12131711	0	0	0	0	1166568	0	0	0	0	0	0	0	0	18115604	3448453	768674	189682	1166568
SRR767719	unknown	CML133	NA	1	10108029	9761954	346075	9761954	0	0	9153161	8585184	4898713	5259429	0	0	0	0	608793	0	0	0	0	0	0	0	0	8148476	1792887	360646	76062	608793
SRR767720	unknown	CML192	NA	1	10236500	9877697	358803	9877697	0	0	9114941	8317946	4750606	5270816	0	0	0	0	762756	0	0	0	0	0	0	0	0	7851424	2685877	383484	83038	762756
SRR767721	unknown	CML202	NA	1	11140488	10747087	393401	10747087	0	0	10012984	9393591	5276250	5582617	0	0	0	0	734103	0	0	0	0	0	0	0	0	8880721	1819187	427611	85259	734103
SRR767722	unknown	CML206	NA	1	8787540	8474246	313294	8474246	0	0	7883132	7414054	4257034	4551024	0	0	0	0	591114	0	0	0	0	0	0	0	0	7013631	1400051	335166	65257	591114
SRR767724	unknown	CML330	NA	1	10488563	10136386	352177	10136386	0	0	9281126	8689142	5002998	5385977	0	0	0	0	855260	0	0	0	0	0	0	0	0	8227371	2046397	378593	83178	855260
SRR767725	unknown	CML411	NA	1	9508841	9199509	309332	9199509	0	0	8670126	8201950	4720124	5011392	0	0	0	0	529383	0	0	0	0	0	0	0	0	7746205	1355930	386635	69110	529383
SRR767726	unknown	CML418	NA	1	11665987	11270523	395464	11270523	0	0	10548252	9930707	5680139	6069710	0	0	0	0	722271	0	0	0	0	0	0	0	0	9378368	1816674	464247	88092	722271
SRR767727	unknown	CML479	NA	1	11395981	10990083	405898	10990083	0	0	10356120	9716374	5548792	5965797	0	0	0	0	633963	0	0	0	0	0	0	0	0	9218103	1903707	405656	92615	633963
SRR767728	unknown	CML504	NA	1	21361420	20626580	734840	20626580	0	0	19413889	18106593	10284903	11024621	0	0	0	0	1212691	0	0	0	0	0	0	0	0	17111662	4089911	818468	176463	1212691
SRR767729	unknown	CML505	NA	1	9919395	9570904	348491	9570904	0	0	9042528	8495749	4851313	5144086	0	0	0	0	528376	0	0	0	0	0	0	0	0	8066141	1657968	354706	74902	528376
SRR767730	unknown	CML511	NA	1	13937009	13456720	480289	13456720	0	0	12666222	11810626	6681270	7173160	0	0	0	0	790498	0	0	0	0	0	0	0	0	11165908	2706422	536009	108709	790498
SRR767731	unknown	CML69	NA	1	10055914	9719883	336031	9719883	0	0	9198594	8667195	5025682	5365743	0	0	0	0	521289	0	0	0	0	0	0	0	0	8197960	1560537	375378	93857	521289
SRR767732	unknown	CML84	NA	1	11429651	11034870	394781	11034870	0	0	10466828	9877578	5665895	6014918	0	0	0	0	568042	0	0	0	0	0	0	0	0	9384947	1651120	402555	90076	568042
SRR767733	unknown	CML85	NA	1	9299152	8965552	333600	8965552	0	0	8418494	7902106	4563542	4833167	0	0	0	0	547058	0	0	0	0	0	0	0	0	7459955	1473597	365217	76934	547058
SRR767735	unknown	CML96	NA	1	11902903	11481947	420956	11481947	0	0	10860243	10218418	5946459	6345082	0	0	0	0	621704	0	0	0	0	0	0	0	0	9696327	1847948	424600	97491	621704
SRR767736	unknown	CML99	NA	1	10235613	9883034	352579	9883034	0	0	9298154	8692240	5126732	5507431	0	0	0	0	584880	0	0	0	0	0	0	0	0	8177184	1925329	433526	81530	584880
SRR767742	unknown	CML103	NA	3	22059820	21395355	664465	21395355	0	0	20354939	19260546	11521908	12244982	0	0	0	0	1040416	0	0	0	0	0	0	0	0	18407719	2945721	672406	180421	1040416
